# Frequency list from Netflix subtitles (80,000 documents) shared here: https://www.youtube.com/watch?v=DwJWld8hW0M	﻿# Frequency list from Netflix subtitles (80,000 documents) shared here: https://www.youtube.com/watch?v=DwJWld8hW0M
# Readings (second column) were added using pykakasi
の	ノ
だ	ダ
は	ハ
た	タ
に	ニ
を	ヲ
が	ガ
て	テ
する	スル
ない	ナイ
よ	ヨ
と	ト
で	デ
か	カ
も	モ
てる	テル
ん	ン
です	デス
ます	マス
ね	ネ
いる	イル
な	ナ
から	カラ
何	ナニ
う	ウ
ある	アル
私	ワタシ
こと	コト
わ	ワ
れる	レル
いい	イイ
そう	ソウ
なる	ナル
じゃ	ジャ
人	ニン
俺	オレ
言う	イウ
この	コノ
たい	タイ
って	ッテ
やる	ヤル
これ	コレ
行く	イク
分かる	ワカル
君	クン
ば	バ
くれる	クレル
それ	ソレ
でも	デモ
ぞ	ゾ
どう	ドウ
見る	ミル
来る	クル
くる	クル
お前	オマエ
さん	サン
けど	ケド
お	オ
思う	オモウ
もう	モウ
その	ソノ
や	ヤ
できる	デキル
あなた	アナタ
さ	サ
だけ	ダケ
僕	ボク
あっ	アッ
ここ	ココ
へ	ヘ
ああ	アア
せる	セル
よう	ヨウ
彼	カレ
あ	ア
まで	マデ
られる	ラレル
たち	タチ
今	イマ
知る	シル
時	トキ
誰	ダレ
え	エ
あの	アノ
聞く	キク
はい	ハイ
出る	デル
話	ハナシ
く	ク
ため	タメ
年	ネン
待つ	マツ
前	マエ
どこ	ドコ
気	キ
音	オト
なぜ	ナゼ
彼女	カノジョ
中	ナカ
うん	ウン
そんな	ソンナ
違う	チガウ
大丈夫	ダイジョウブ
ぬ	ヌ
自分	ジブン
なんて	ナンテ
のに	ノニ
いく	イク
男	オトコ
よい	ヨイ
まだ	マダ
し	シ
ありがとう	アリガトウ
ちょっと	チョット
また	マタ
みんな	ミンナ
いや	イヤ
やめる	ヤメル
かも	カモ
悪い	ワルイ
いう	イウ
死ぬ	シヌ
みたい	ミタイ
だって	ダッテ
日	ニチ
家	イエ
みる	ミル
時間	ジカン
早い	ハヤイ
手	テ
えっ	エッ
もの	モノ
すごい	スゴイ
話す	ハナス
ダメ	ダメ
くださる	クダサル
殺す	コロス
戻る	モドル
なんだ	ナンダ
持つ	モツ
帰る	カエル
だから	ダカラ
こんな	コンナ
今日	キョウ
ら	ラ
目	メ
入る	イル
仕事	シゴト
よく	ヨク
好き	スキ
必要	ヒツヨウ
ちゃん	チャン
ちゃう	チャウ
より	ヨリ
考える	カンガエル
会う	アウ
女	オンナ
じゃあ	ジャア
食べる	タベル
同じ	オナジ
ねえ	ネエ
はず	ハズ
あれ	アレ
という	トイウ
ええ	エエ
本当に	ホントウニ
おい	オイ
あと	アト
あんた	アンタ
とか	トカ
使う	ツカウ
もらう	モラウ
ぜ	ゼ
ほう	ホウ
子	コ
作る	ツクル
さあ	サア
すぐ	スグ
分	フン
先生	センセイ
問題	モンダイ
すぎる	スギル
様	サマ
次	ツギ
ご	ゴ
他	ホカ
バカ	バカ
入れる	イレル
だが	ダガ
心配	シンパイ
出す	ダス
信じる	シンジル
頼む	タノム
そして	ソシテ
まあ	マア
電話	デンワ
なさる	ナサル
車	クルマ
子供	コドモ
一	イチ
者	モノ
ただ	タダ
私たち	ワタシタチ
お願い	オネガイ
一緒に	イッショニ
しか	シカ
見える	ミエル
べし	ベシ
後	ノチ
わけ	ワケ
こっち	コッチ
として	トシテ
どうも	ドウモ
人間	ニンゲン
ママ	ママ
忘れる	ワスレル
声	コエ
友達	トモダチ
もっと	モット
呼ぶ	ヨブ
顔	カオ
力	チカラ
しまう	シマウ
最高	サイコウ
うち	ウチ
飲む	ノム
こう	コウ
方	ホウ
つく	ツク
つける	ツケル
ウソ	ウソ
そこ	ソコ
教える	オシエル
取る	トル
なんか	ナンカ
たり	タリ
女性	ジョセイ
助ける	タスケル
俺たち	オレタチ
少し	スコシ
でる	デル
何だ	ナンダ
おく	オク
うる	ウル
名前	ナマエ
ちゃ	チャ
もん	モン
家族	カゾク
いつも	イツモ
万	マン
ごめん	ゴメン
世界	セカイ
本当	ホントウ
ま	マ
歳	トシ
あいつ	アイツ
逃げる	ニゲル
せい	セイ
最後	サイゴ
奴	ヤツ
娘	ムスメ
頭	アタマ
生きる	イキル
かける	カケル
無理	ムリ
ほら	ホラ
パパ	パパ
見せる	ミセル
関係	カンケイ
うまい	ウマイ
それで	ソレデ
どんな	ドンナ
め	メ
どうぞ	ドウゾ
ござる	ゴザル
心	ココロ
守る	マモル
場所	バショ
終わる	オワル
相手	アイテ
我々	ワレワレ
ので	ノデ
あげる	アゲル
変わる	カワル
ずっと	ズット
寝る	ネル
買う	カウ
ほしい	ホシイ
絶対	ゼッタイ
体	カラダ
部屋	ヘヤ
以上	イジョウ
先	サキ
１つ	１ツ
彼ら	カレラ
頑張る	ガンバル
明日	アシタ
よし	ヨシ
上	ウエ
ほど	ホド
怖い	コワイ
神	カミ
強い	シイ
全部	ゼンブ
どうして	ドウシテ
楽しい	タノシイ
もちろん	モチロン
すべて	スベテ
回	カイ
息子	ムスコ
おる	オル
夢	ユメ
物	モノ
うわ	ウワ
始める	ハジメル
まさか	マサカ
らしい	ラシイ
つもり	ツモリ
とき	トキ
金	キン
見つける	ミツケル
初めて	ハジメテ
いつ	イツ
起きる	オキル
本	ホン
とる	トル
結婚	ケッコン
大変	タイヘン
では	デハ
愛す	アイス
覚える	オボエル
元気	ゲンキ
がる	ガル
続ける	ツヅケル
人生	ジンセイ
なあ	ナア
意味	イミ
店	ミセ
とく	トク
黙る	ダマル
こいつ	コイツ
かい	カイ
やつ	ヤツ
まま	ママ
書く	カク
そういう	ソウイウ
乗る	ノル
など	ナド
所	トコロ
しれる	シレル
第	ダイ
一緒	イッショ
警察	ケイサツ
言葉	コトバ
しかし	シカシ
皆	ミナ
気持ち	キモチ
父	チチ
理由	リユウ
きっと	キット
受ける	ウケル
ひどい	ヒドイ
言える	イエル
決める	キメル
どういう	ドウイウ
やっぱり	ヤッパリ
元	モト
最初	サイショ
うつ	ウツ
ドル	ドル
犬	イヌ
事	コト
男性	ダンセイ
こそ	コソ
変	ヘン
き	キ
準備	ジュンビ
母	ハハ
番	バン
夜	ヨル
仲間	ナカマ
かしら	カシラ
敵	テキ
外	ソト
昔	ムカシ
感じる	カンジル
危険	キケン
つ	ツ
なんで	ナンデ
怒る	イカル
写真	シャシン
数	カズ
連絡	レンラク
空	ソラ
愛	アイ
命	イノチ
確かに	タシカニ
ところ	トコロ
くらい	クライ
大事	ダイジ
り	リ
大	ダイ
一番	イチバン
うれしい	ウレシイ
急ぐ	イソグ
いける	イケル
どうか	ドウカ
約束	ヤクソク
動く	ウゴク
ばかり	バカリ
ハッ	ハッ
別	ベツ
許す	ユルス
水	ミズ
イヤ	イヤ
おお	オオ
選ぶ	エラブ
とおり	トオリ
王	オウ
用	ヨウ
かかる	カカル
消える	キエル
何で	ナンデ
止める	ヤメル
妻	ツマ
ハア	ハア
今度	コンド
残る	ノコル
悟	サトシ
そうね	ソウネ
送る	オクル
笑い声	ワライコエ
何でも	ナンデモ
欲しい	ホシイ
口	クチ
こちら	コチラ
おいしい	オイシイ
海	ウミ
一体	イッタイ
ちる	チル
探す	サガス
全員	ゼンイン
感じ	カンジ
行う	オコナウ
面白い	オモシロイ
幸せ	シアワセ
いいえ	イイエ
任せる	マカセル
ちゃんと	チャント
国	クニ
多い	オオイ
名	メイ
わかる	ワカル
度	ド
開く	ヒラク
学校	ガッコウ
はっ	ハッ
開ける	ヒラケル
さっき	サッキ
間	カン
伝える	ツタエル
うい	ウイ
ながら	ナガラ
じ	ジ
新しい	アタラシイ
野郎	ヤロウ
高い	タカイ
父親	チチオヤ
戦う	タタカウ
星	ホシ
料理	リョウリ
件	ケン
船	フネ
驚く	オドロク
調べる	シラベル
とても	トテモ
母親	ハハオヤ
チーム	チーム
やあ	ヤア
事件	ジケン
今回	コンカイ
勝つ	カツ
道	ミチ
情報	ジョウホウ
失う	ウシナウ
夫	オット
痛い	イタイ
全て	スベテ
なに	ナニ
父さん	トウサン
これから	コレカラ
終わり	オワリ
姿	スガタ
捜す	サガス
変える	カエル
今夜	コンヤ
もし	モシ
失礼	シツレイ
マジ	マジ
あー	アー
普通	フツウ
連れる	ツレル
合う	アウ
それに	ソレニ
お母さん	オカアサン
座る	スワル
あんな	アンナ
下	シタ
つまり	ツマリ
ドア	ドア
母さん	カアサン
クソ	クソ
切る	キル
嫌	イヤ
得る	エル
方法	ホウホウ
撃つ	ウツ
聞こえる	キコエル
える	エル
フッ	フッ
一同	イチドウ
よろしく	ヨロシク
確認	カクニン
読む	ヨム
はあ	ハア
落ちる	オチル
簡単	カンタン
状況	ジョウキョウ
銃	ジュウ
感謝	カンシャ
なん	ナン
負ける	マケル
なんです	ナンデス
必ず	カナラズ
全然	ゼンゼン
立つ	タツ
気分	キブン
ごめんなさい	ゴメンナサイ
なれる	ナレル
み	ミ
る	ル
冗談	ジョウダン
捨てる	ステル
かわいい	カワイイ
すみません	スミマセン
おっ	オッ
残念	ザンネン
なるほど	ナルホド
そ	ソ
皆さん	ミナサン
わし	ワシ
殴る	ナグル
町	マチ
泣く	ナク
実は	ジツハ
ふる	フル
まったく	マッタク
犯人	ハンニン
質問	シツモン
落ち着く	オチツク
とにかく	トニカク
離れる	ハナレル
あら	アラ
病院	ビョウイン
んで	ンデ
酒	サケ
隠す	カクス
について	ニツイテ
長い	ナガイ
食う	クウ
頃	ゴロ
お金	オキン
返す	カエス
遅い	オソイ
ゲーム	ゲーム
ホント	ホント
困る	コマル
気づく	キヅク
渡す	ワタス
売る	ウル
こ	コ
服	フク
ちまう	チマウ
血	チ
死	シ
楽しむ	タノシム
結果	ケッカ
足	アシ
働く	ハタラク
映画	エイガ
すむ	スム
平気	ヘイキ
け	ケ
じゃん	ジャン
見つかる	ミツカル
まず	マズ
最近	サイキン
認める	ミトメル
与える	アタエル
会社	カイシャ
お父さん	オトウサン
花	ハナ
計画	ケイカク
存在	ソンザイ
先輩	センパイ
ぐらい	グライ
きれい	キレイ
馬	ウマ
にとって	ニトッテ
了解	リョウカイ
成功	セイコウ
ど	ド
会える	アエル
説明	セツメイ
良い	ヨイ
おかげ	オカゲ
始まる	ハジマル
救う	スクウ
木	キ
本気	ホンキ
週間	シュウカン
薬	クスリ
難しい	ムズカシイ
大きな	オオキナ
笑う	ワラウ
とこ	トコ
しっかり	シッカリ
結構	ケッコウ
おはよう	オハヨウ
社長	シャチョウ
食事	ショクジ
街	マチ
走る	ハシル
失敗	シッパイ
昨日	キノウ
向かう	ムカウ
あの子	アノコ
当然	トウゼン
払う	ハラウ
要る	イル
証拠	ショウコ
奪う	ウバウ
置く	オク
二	ニ
朝	アサ
選手	センシュ
つらい	ツライ
通り	トウリ
優しい	ヤサシイ
手伝う	テツダウ
答える	コタエル
攻撃	コウゲキ
着る	キル
用意	ヨウイ
今まで	イママデ
理解	リカイ
銀	ギン
秘密	ヒミツ
以外	イガイ
決まる	キマル
似る	ニル
ろ	ロ
いただく	イタダク
試合	シアイ
おかしい	オカシイ
別に	ベツニ
的	テキ
いろいろ	イロイロ
住む	スム
火	ヒ
アメリカ	アメリカ
村	ムラ
月	ガツ
さすが	サスガ
たくさん	タクサン
っていう	ッテイウ
そんなに	ソンナニ
上げる	アゲル
妹	イモウト
島	シマ
求める	モトメル
美しい	ウツクシイ
ジョン	ジョン
邪魔	ジャマ
す	ス
本物	ホンモノ
てめえ	テメエ
とも	トモ
よる	ヨル
軍	グン
助かる	タスカル
真	マコト
パーティー	パーティー
キス	キス
すばらしい	スバラシイ
撮る	トル
点	テン
何とか	ナントカ
曲	キョク
位	クライ
味	アジ
調子	チョウシ
させる	サセル
まるで	マルデ
協力	キョウリョク
ファン	ファン
特別	トクベツ
おめでとう	オメデトウ
行ける	イケル
おう	オウ
無事	ブジ
十分	ジュウブン
もらえる	モラエル
ン	ン
忙しい	イソガシイ
生徒	セイト
２つ	２ツ
未来	ミライ
っす	ッス
南	ミナミ
親	オヤ
州	シュウ
戦い	タタカイ
キロ	キロ
貸す	カス
ステキ	ステキ
罪	ツミ
聖	ヒジリ
大好き	ダイスキ
狙う	ネラウ
経験	ケイケン
人々	ヒトビト
大学	ダイガク
若い	ワカイ
くん	クン
もしもし	モシモシ
友人	ユウジン
思い出す	オモイダス
ほる	ホル
どれ	ドレ
気に入る	キニイル
歩く	アルク
女の子	オンナノコ
続く	ツヅク
身	ミ
こんにちは	コンニチハ
練習	レンシュウ
弟	オトウト
号	ゴウ
嫌い	キライ
僕ら	ボクラ
止まる	トマル
盗む	ヌスム
音楽	オンガク
間違い	マチガイ
チャンス	チャンス
過去	カコ
最悪	サイアク
いえ	イエ
生まれる	ウマレル
逮捕	タイホ
光	ヒカリ
だったら	ダッタラ
オレ	オレ
恋人	コイビト
デート	デート
どっち	ドッチ
生活	セイカツ
急	キュウ
客	キャク
進む	ススム
歌う	ウタウ
ひる	ヒル
歌	ウタ
腕	ウデ
考え	カンガエ
やっと	ヤット
だい	ダイ
毎日	マイニチ
飛ぶ	トブ
ゆっくり	ユックリ
どの	ドノ
近く	チカク
ったら	ッタラ
風	カゼ
危ない	アブナイ
安心	アンシン
諦める	アキラメル
安全	アンゼン
テレビ	テレビ
絵	エ
疲れる	ツカレル
記憶	キオク
現れる	アラワレル
そっち	ソッチ
兄	アニ
済む	スム
貴様	キサマ
追う	オウ
作戦	サクセン
べ	ベ
こういう	コウイウ
正直	ショウジキ
連中	レンチュウ
すいません	スイマセン
謝る	アヤマル
携帯	ケイタイ
あそこ	アソコ
真実	シンジツ
遊ぶ	アソブ
剣	ツルギ
命令	メイレイ
勝手	カッテ
多く	オオク
目的	モクテキ
子供たち	コドモタチ
番組	バングミ
可能性	カノウセイ
まずは	マズハ
かなり	カナリ
奴ら	ヤツラ
上がる	アガル
ナレーション	ナレーション
行動	コウドウ
くせ	クセ
完璧	カンペキ
正しい	タダシイ
ケンカ	ケンカ
わっ	ワッ
秒	ビョウ
楽しみ	タノシミ
兵士	ヘイシ
もう一度	モウイチド
場合	バアイ
マン	マン
宇宙	ウチュウ
望む	ノゾム
楽	ラク
息	イキ
色	ショク
ナレーター	ナレーター
休む	ヤスム
あたし	アタシ
大切	タイセツ
患者	カンジャ
そりゃ	ソリャ
事故	ジコ
戦争	センソウ
責任	セキニン
さくら	サクラ
触る	フル
ちょ	チョ
確か	タシカ
別れる	ワカレル
残す	ノコス
助け	タスケ
室	シツ
紹介	ショウカイ
っけ	ッケ
状態	ジョウタイ
消す	ケス
胸	ムネ
いくら	イクラ
報告	ホウコク
魔法	マホウ
重要	ジュウヨウ
引く	ヒク
自由	ジユウ
打つ	ウツ
フン	フン
弁護士	ベンゴシ
観客	カンキャク
ほか	ホカ
着く	ツク
キム	キム
興味	キョウミ
使える	ツカエル
勉強	ベンキョウ
後ろ	ウシロ
バレる	バレル
警官	ケイカン
時代	ジダイ
様子	ヨウス
会長	カイチョウ
組	クミ
大人	オトナ
たって	タッテ
親父	オヤジ
くい	クイ
なら	ナラ
山	ヤマ
期待	キタイ
倒す	タオス
イカ	イカ
もう少し	モウスコシ
襲う	オソウ
病気	ビョウキ
起こす	オコス
うるさい	ウルサイ
小さい	チイサイ
傷	キズ
完全	カンゼン
捕まえる	ツカマエル
メール	メール
断る	コトワル
トイレ	トイレ
ホテル	ホテル
君たち	クンタチ
城	シロ
そっ	ソッ
大きい	オオキイ
それから	ソレカラ
壁	カベ
両親	リョウシン
陛下	ヘイカ
描く	エガク
運ぶ	ハコブ
深い	フカイ
ホントに	ホントニ
ども	ドモ
日本語字幕	ニホンゴジマク
超	チョウ
鍵	カギ
特に	トクニ
大統領	ダイトウリョウ
迎える	ムカエル
地球	チキュウ
解決	カイケツ
ケガ	ケガ
雪	ユキ
だけど	ダケド
役	ヤク
そろそろ	ソロソロ
記録	キロク
僕たち	ボクタチ
近づく	チカヅク
ふざける	フザケル
刑事	ケイジ
そば	ソバ
捜査	ソウサ
仕方	シカタ
天	テン
魂	タマシイ
答え	コタエ
首	クビ
喜ぶ	ヨロコブ
会	カイ
運命	ウンメイ
しかも	シカモ
達	トオル
勝負	ショウブ
２人とも	２ニントモ
二度と	ニドト
肉	ニク
向こう	ムコウ
ボス	ボス
いつか	イツカ
届く	トドク
武器	ブキ
借りる	カリル
医者	イシャ
腹	ハラ
そこで	ソコデ
矢	ヤ
日本	ニッポン
部	ブ
原因	ゲンイン
さま	サマ
魚	サカナ
兄貴	アニキ
話せる	ハナセル
事実	ジジツ
さえ	サエ
落とす	オトス
残り	ノコリ
たん	タン
今すぐ	イマスグ
予定	ヨテイ
そいつ	ソイツ
担当	タントウ
ポイント	ポイント
手紙	テガミ
構う	カマウ
作品	サクヒン
鳴き声	ナキゴエ
こんなに	コンナニ
ダンス	ダンス
年間	ネンカン
突然	トツゼン
兄さん	ニイサン
うーん	ウーン
刑務所	ケイムショ
ボール	ボール
兄弟	キョウダイ
コーヒー	コーヒー
わあ	ワア
髪	カミ
のび太	ノビタ
何度も	ナンドモ
過ぎる	スギル
アル	アル
千	セン
しま	シマ
回る	マワル
集める	アツメル
おじさん	オジサン
足りる	タリル
発見	ハッケン
甘い	アマイ
今から	イマカラ
夜叉	ヤシャ
ふう	フウ
意見	イケン
ようこそ	ヨウコソ
下がる	サガル
ここから	ココカラ
外す	ハズス
久しぶり	ヒサシブリ
想像	ソウゾウ
いっぱい	イッパイ
森	モリ
わたし	ワタシ
枚	マイ
学ぶ	マナブ
人たち	ニンタチ
監督	カントク
飯	メシ
悪魔	アクマ
旅	タビ
あっち	アッチ
不安	フアン
従う	シタガウ
現場	ゲンバ
試す	タメス
リン	リン
ミ	ミ
十	ジュウ
正解	セイカイ
なり	ナリ
去る	サル
ムダ	ムダ
ガン	ガン
誘う	サソウ
付ける	ツケル
最も	モットモ
それでも	ソレデモ
任務	ニンム
勝てる	カテル
嫌う	キラウ
反応	ハンノウ
黒	クロ
よせ	ヨセ
博士	ハカセ
待てる	マテル
自信	ジシン
氏	シ
勝利	ショウリ
間違う	マチガウ
動物	ドウブツ
希望	キボウ
こら	コラ
相談	ソウダン
姉	アネ
覚悟	カクゴ
ベッド	ベッド
当たる	アタル
後で	アトデ
くう	クウ
い	イ
と言った	トイッッタ
奥さん	オクサン
恋	コイ
思い	オモイ
取れる	トレル
いい子	イイコ
太	タ
起こる	オコル
立てる	タテル
セックス	セックス
三	サン
ありがと	アリガト
ジャック	ジャック
過ごす	スゴス
誕生日	タンジョウビ
その後	ソノノチ
撮影	サツエイ
隠れる	カクレル
信用	シンヨウ
カメラ	カメラ
集まる	アツマル
結局	ケッキョク
生	ナマ
出せる	ダセル
速い	ハヤイ
研究	ケンキュウ
望み	ノゾミ
なのに	ナノニ
ノ	ノ
努力	ドリョク
直す	ナオス
カネ	カネ
永遠	エイエン
瞬間	シュンカン
少年	ショウネン
へえ	ヘエ
現実	ゲンジツ
左	ヒダリ
ついに	ツイニ
へん	ヘン
鳥	トリ
ジャン	ジャン
踊る	オドル
見事	ミゴト
近い	チカイ
影響	エイキョウ
治療	チリョウ
耳	ミミ
なくなる	ナクナル
押す	オス
美	ビ
ショー	ショー
緊張	キンチョウ
申し訳	モウシワケ
っと	ット
木村	キムラ
暮らす	クラス
切れる	キレル
代	ダイ
壊す	コワス
カッコ	カッコ
辞める	ヤメル
どうせ	ドウセ
新	シン
それとも	ソレトモ
利用	リヨウ
遅れる	オクレル
動き	ウゴキ
乾杯	カンパイ
付き合う	ツキアウ
吸う	スウ
マネ	マネ
手術	シュジュツ
傷つける	キズツケル
げ	ゲ
それでは	ソレデハ
小さな	チイサナ
思える	オモエル
ける	ケル
静かに	シズカニ
完成	カンセイ
泣き声	ナキコエ
当時	トウジ
どく	ドク
マイケル	マイケル
靴	クツ
味方	ミカタ
ちょうだい	チョウダイ
松	マツ
たぶん	タブン
後悔	コウカイ
そうですね	ソウデスネ
翔	ショウ
検査	ケンサ
調査	チョウサ
っぽい	ッポイ
最低	サイテイ
王子	オウジ
バス	バス
サム	サム
スター	スター
形	カタチ
レベル	レベル
雨	アメ
実際	ジッサイ
そのまま	ソノママ
あの人	アノニン
リー	リー
長	チョウ
代表	ダイヒョウ
助	ジョ
社	シャ
もうすぐ	モウスグ
寂しい	サビシイ
席	セキ
高校	コウコウ
億	オク
映像	エイゾウ
拍手	ハクシュ
恥ずかしい	ハズカシイ
メートル	メートル
指示	シジ
によって	ニヨッテ
慣れる	ナレル
面倒	メンドウ
それも	ソレモ
カード	カード
雄	オス
ミス	ミス
合わせる	アワセル
我慢	ガマン
彼氏	カレシ
誤解	ゴカイ
どおり	ドオリ
ロ	ロ
参加	サンカ
やっぱ	ヤッパ
被害者	ヒガイシャ
出会う	デアウ
大勢	オオゼイ
おいで	オイデ
穴	アナ
オリジナル	オリジナル
政府	セイフ
降りる	オリル
集中	シュウチュウ
ドン	ドン
内	ナイ
重い	オモイ
疑う	ウタガウ
反対	ハンタイ
たたく	タタク
捕まる	ツカマル
歓声	カンセイ
による	ニヨル
耐える	タエル
それだけ	ソレダケ
倒れる	タオレル
周り	マワリ
全く	マッタク
ビル	ビル
到着	トウチャク
有名	ユウメイ
抜く	ヌク
能力	ノウリョク
移動	イドウ
ジョー	ジョー
あまり	アマリ
大きく	オオキク
逆	ギャク
厳しい	キビシイ
親友	シンユウ
式	シキ
・	・
裏切る	ウラギル
ガキ	ガキ
戻す	モドス
アン	アン
破壊	ハカイ
それなら	ソレナラ
一生	イッショウ
契約	ケイヤク
お兄ちゃん	オニイチャン
猫	ネコ
今後	コンゴ
感情	カンジョウ
寒い	サムイ
石	イシ
次回	ジカイ
祈る	イノル
やはり	ヤハリ
ついてる	ツイテル
それより	ソレヨリ
寅次郎	トラジロウ
しばらく	シバラク
避ける	サケル
古い	フルイ
関わる	カカワル
隣	トナリ
爆発	バクハツ
出発	シュッパツ
流す	ナガス
運転	ウンテン
悲しい	カナシイ
前回	ゼンカイ
現在	ゲンザイ
優勝	ユウショウ
すげる	スゲル
開始	カイシ
機会	キカイ
応援	オウエン
多分	タブン
妙	ミョウ
階	カイ
荷物	ニモツ
歩	ホ
小	ショウ
やすい	ヤスイ
バー	バー
地獄	ジゴク
かく	カク
大会	タイカイ
焼く	ヤク
メンバー	メンバー
部長	ブチョウ
ムリ	ムリ
証明	ショウメイ
きょう	キョウ
杯	ハイ
増える	フエル
指	ユビ
さらに	サラニ
せっかく	セッカク
常に	ツネニ
脳	ノウ
パン	パン
遠い	トオイ
途中	トチュウ
わける	ワケル
弱い	ヨワイ
姫	ヒメ
なかなか	ナカナカ
他人	タニン
箱	ハコ
満足	マンゾク
円	エン
右	ミギ
立派	リッパ
クラブ	クラブ
スタッフ	スタッフ
ドラゴン	ドラゴン
山里	ヤマザト
以前	イゼン
川	カワ
パワー	パワー
全	ゼン
歴史	レキシ
プレゼント	プレゼント
兵	ヘイ
骨	ホネ
失礼します	シツレイシマス
としても	トシテモ
例	レイ
例えば	タトエバ
裏	ウラ
シェフ	シェフ
ぼく	ボク
個	コ
対	ツイ
えー	エー
マスター	マスター
許可	キョカ
はぁ	ハァ
部下	ブカ
遊び	アソビ
やれる	ヤレル
だます	ダマス
法	ホウ
地	チ
ないで	ナイデ
データ	データ
ロック	ロック
作業	サギョウ
誰にも	ダレニモ
判断	ハンダン
ねん	ネン
ふん	フン
殿	ドノ
女子	ジョシ
ワン	ワン
ばあちゃん	バアチャン
夏	ナツ
殺人	サツジン
百	ヒャク
いたす	イタス
ケーキ	ケーキ
マーク	マーク
恐れる	オソレル
才能	サイノウ
黒人	コクジン
尽くす	ツクス
無視	ムシ
ルパン	ルパン
ボク	ボク
場	バ
レイ	レイ
脚	アシ
離す	ハナス
新た	アラタ
ねる	ネル
抜ける	ヌケル
どうでも	ドウデモ
上手	ジョウズ
効く	キク
毒	ドク
大した	タイシタ
店員	テンイン
戦	セン
王様	オウサマ
プロ	プロ
銃声	ジュウセイ
なぁ	ナァ
船長	センチョウ
かん	カン
ルール	ルール
挑戦	チョウセン
悪	アク
進める	ススメル
鬼	オニ
眠る	ネムル
ところで	トコロデ
怒り	イカリ
うわる	ウワル
ネット	ネット
禁止	キンシ
なんと	ナント
出かける	デカケル
介	スケ
通る	トウル
教会	キョウカイ
ドラえもん	ドラエモン
自然	シゼン
壊れる	コワレル
さて	サテ
我が	ワガ
ナミ	ナミ
卵	タマゴ
半分	ハンブン
離婚	リコン
願う	ネガウ
おやすみ	オヤスミ
お待ち	オマチ
３つ	３ツ
クビ	クビ
悲鳴	ヒメイ
価値	カチ
落ち着ける	オチツケル
少ない	スクナイ
減る	ヘル
タイプ	タイプ
太郎	タロウ
受け入れる	ウケイレル
不思議	フシギ
取引	トリヒキ
サラ	サラ
主	シュ
東	ヒガシ
本人	ホンニン
蹴る	ケル
窓	マド
こい	コイ
お互い	オタガイ
倍	バイ
クリスマス	クリスマス
キング	キング
まさに	マサニ
いろんな	イロンナ
遺体	イタイ
かごめ	カゴメ
屋	ヤ
解放	カイホウ
刺す	サス
苦労	クロウ
内容	ナイヨウ
英語	エイゴ
吐く	ハク
死体	シタイ
発	ハツ
痛み	イタミ
登場	トウジョウ
変化	ヘンカ
ビール	ビール
竜	リュウ
おれ	オレ
機	キ
放す	ハナス
春	ハル
育てる	ソダテル
医師	イシ
ちょうど	チョウド
テスト	テスト
愛する	アイスル
装置	ソウチ
妊娠	ニンシン
完了	カンリョウ
ころ	コロ
かなう	カナウ
デカ	デカ
熱い	アツイ
賢い	カシコイ
得意	トクイ
平	タイラ
ニュース	ニュース
記者	キシャ
おら	オラ
しゃべる	シャベル
つかむ	ツカム
勇気	ユウキ
楠	クスノキ
可能	カノウ
謎	ナゾ
側	ガワ
恐ろしい	オソロシイ
たま	タマ
ごと	ゴト
もしかして	モシカシテ
似合う	ニアウ
艦長	カンチョウ
少女	ショウジョ
アッ	アッ
技術	ギジュツ
仲	ナカ
どちら	ドチラ
今年	コンネン
成長	セイチョウ
笑顔	エガオ
丸	マル
まい	マイ
投げる	ナゲル
足音	アシオト
遭う	アウ
飛行機	ヒコウキ
氷	コオリ
クリ	クリ
訓練	クンレン
おなか	オナカ
北	キタ
向ける	ムケル
触れる	フレル
意識	イシキ
はっきり	ハッキリ
隊	タイ
代わりに	カワリニ
居場所	イバショ
決して	ケッシテ
隊長	タイチョウ
ゲイ	ゲイ
監視	カンシ
もつ	モツ
こりゃ	コリャ
汚い	キタナイ
お茶	オチャ
台	ダイ
サイン	サイン
昨夜	サクヤ
記事	キジ
はじめ	ハジメ
発表	ハッピョウ
偶然	グウゼン
赤	アカ
順調	ジュンチョウ
中国	チュウゴク
土地	トチ
ただいま	タダイマ
結婚式	ケッコンシキ
軽い	カルイ
気付く	キヅク
違い	チガイ
自殺	ジサツ
終了	シュウリョウ
注意	チュウイ
稼ぐ	カセグ
初	ハツ
教授	キョウジュ
信頼	シンライ
午後	ゴゴ
放つ	ホウッツ
実	ミ
酔う	ヨウ
心臓	シンゾウ
勝ち	カチ
たつ	タツ
とりあえず	トリアエズ
喜んで	ヨロコンデ
妖怪	ヨウカイ
何者	ナニモノ
組織	ソシキ
ドイツ	ドイツ
雇う	ヤトウ
部分	ブブン
エンジン	エンジン
白	シロ
だもの	ダモノ
面	メン
システム	システム
今朝	ケサ
人気	ニンキ
すでに	スデニ
ジム	ジム
ものを	モノヲ
恩	オン
世話	セワ
チャン	チャン
付く	ツク
恐怖	キョウフ
暇	ヒマ
ぶる	ブル
だらけ	ダラケ
聞ける	キケル
迷う	マヨウ
涙	ナミダ
番号	バンゴウ
唯一	ユイイツ
こうして	コウシテ
ワイン	ワイン
空気	クウキ
伝説	デンセツ
みせる	ミセル
会議	カイギ
フランス	フランス
いい人	イイニン
掃除	ソウジ
余計	ヨケイ
知り合い	シリアイ
亡くなる	ナクナル
じろう	ジロウ
なれば	ナレバ
しん	シン
マイク	マイク
案内	アンナイ
我ら	ワレラ
ほとんど	ホトンド
リーダー	リーダー
素晴らしい	スバラシイ
お話	オハナシ
ドクター	ドクター
魔	マ
ゼロ	ゼロ
着信音	チャクシンオト
態度	タイド
トン	トン
犠牲	ギセイ
思い出	オモイデ
傷つく	キズツク
必死	ヒッシ
のう	ノウ
示す	シメス
間に合う	マニアウ
条件	ジョウケン
界	カイ
赤ちゃん	アカチャン
取り戻す	トリモドス
つながる	ツナガル
当てる	アテル
珍しい	メズラシイ
におい	ニオイ
破る	ヤブル
いずれ	イズレ
興奮	コウフン
夫婦	フウフ
新八	シンハチ
洗う	アラウ
無駄	ムダ
扉	トビラ
すてき	ステキ
会話	カイワ
のみ	ノミ
超える	コエル
おおう	オオウ
よろしい	ヨロシイ
近藤	コンドウ
携帯電話	ケイタイデンワ
影	カゲ
爆弾	バクダン
眠れる	ネムレル
苦しむ	クルシム
位置	イチ
神様	カミサマ
証言	ショウゲン
つる	ツル
納得	ナットク
闇	ヤミ
将軍	ショウグン
知らせる	シラセル
目指す	メザス
立場	タチバ
通信	ツウシン
クラス	クラス
いらっしゃる	イラッシャル
ぼる	ボル
ベル	ベル
迷惑	メイワク
回す	マワス
孫	マゴ
冷たい	ツメタイ
裁判	サイバン
旅行	リョコウ
間違える	マチガエル
巨大	キョダイ
苦手	ニガテ
女王	ジョオウ
出身	シュッシン
美人	ビジン
戻れる	モドレル
鼻	ハナ
本当は	ホントウハ
ベン	ベン
嘘	ウソ
育つ	ソダツ
夕食	ユウショク
青	アオ
ハイ	ハイ
広い	ヒロイ
脅す	オドス
ひと	ヒト
限界	ゲンカイ
ド	ド
ってば	ッテバ
返事	ヘンジ
組む	クム
爆発音	バクハツオン
やり方	ヤリホウ
秋	アキ
正体	ショウタイ
庭	ニワ
一部	イチブ
動かす	ウゴカス
発射	ハッシャ
いきなり	イキナリ
かわいそう	カワイソウ
文句	モンク
施設	シセツ
ゆう	ユウ
ロス	ロス
世	ヨ
脱ぐ	ヌグ
何だか	ナンダカ
平和	ヘイワ
人物	ジンブツ
四	シ
抱く	ダク
出来る	デキル
直接	チョクセツ
オーケー	オーケー
おばさん	オバサン
責める	セメル
天才	テンサイ
幸運	コウウン
教師	キョウシ
鈴木	スズキ
ほんと	ホント
犯す	オカス
選択	センタク
徳井	トクイ
ぜひ	ゼヒ
たった	タッタ
してやる	シテヤル
距離	キョリ
弾	ダン
物語	モノガタリ
歯	ハ
横	ヨコ
シン	シン
アホ	アホ
ラ	ラ
しかた	シカタ
格好	カッコウ
ううん	ウウン
限り	カギリ
約	ヤク
流れる	ナガレル
まずい	マズイ
ゴール	ゴール
自ら	ミズカラ
ばっかり	バッカリ
同士	ドウシ
ニューヨーク	ニューヨーク
暗い	クライ
活動	カツドウ
あんまり	アンマリ
将来	ショウライ
浜崎	ハマサキ
誓う	チカウ
海賊	カイゾク
カン	カン
権利	ケンリ
優秀	ユウシュウ
異常	イジョウ
貴之	タカユキ
橋	ハシ
いくつ	イクツ
混乱	コンラン
年代	ネンダイ
姉さん	ネエサン
レース	レース
実験	ジッケン
匹	ヒキ
かむ	カム
はる	ハル
男の子	オトコノコ
再び	フタタビ
赤い	アカイ
入り	イリ
逃がす	ニガス
乗せる	ノセル
尻	シリ
回復	カイフク
モデル	モデル
すぎ	スギ
次に	ツギニ
いやあ	イヤア
そしたら	ソシタラ
荒い	アライ
レッド	レッド
脱出	ダッシュツ
最大	サイダイ
フリ	フリ
悩む	ナヤム
はねる	ハネル
ネタ	ネタ
トム	トム
スーツ	スーツ
韓国	カンコク
事務所	ジムショ
お礼	オレイ
治る	ナオル
綾	アヤ
おやじ	オヤジ
ピーター	ピーター
臭い	クサイ
置いて	オイテ
ずつ	ズツ
いやいや	イヤイヤ
授業	ジュギョウ
ひとつ	ヒトツ
以来	イライ
カ月	カガツ
この世	コノヨ
何て	ナンテ
ジェーン	ジェーン
怪しい	アヤシイ
受け取る	ウケトル
参る	マイル
下さる	クダサル
退屈	タイクツ
種	タネ
白人	ハクジン
虎	トラ
夫人	フジン
師匠	シショウ
食べ物	タベモノ
ハッピー	ハッピー
東京	トウキョウ
説得	セットク
赤ん坊	アカンボウ
って言う	ッテイウ
学生	ガクセイ
桃	モモ
スタート	スタート
まっ	マッ
ダン	ダン
いち	イチ
ヒーロー	ヒーロー
らい	ライ
父上	チチウエ
香り	カオリ
龍	リュウ
奥	オク
男子	ダンシ
程度	テイド
聴く	キク
奇跡	キセキ
書類	ショルイ
犯罪	ハンザイ
性	セイ
握る	ニギル
びっくり	ビックリ
事情	ジジョウ
行き	イキ
スー	スー
流	リュウ
護	ゴ
加える	クワエル
お客様	オキャクサマ
とんでも	トンデモ
巻き込む	マキコム
扱い	アツカイ
複雑	フクザツ
一方	イッポウ
部隊	ブタイ
決断	ケツダン
つい	ツイ
シリーズ	シリーズ
八	ハチ
冬	フユ
効果	コウカ
殿下	デンカ
園	ソノ
ドレス	ドレス
うめき声	ウメキコエ
潰す	ツブス
ハァハァ	ハァハァ
提案	テイアン
神楽	カグラ
により	ニヨリ
激しい	ハゲシイ
アハハ	アハハ
人類	ジンルイ
哲也	テツヤ
舞台	ブタイ
ろう	ロウ
ゾンビ	ゾンビ
トップ	トップ
日向	ヒュウガ
目標	モクヒョウ
交渉	コウショウ
訴える	ウッタエル
何事	ナニゴト
どうしても	ドウシテモ
之	ユキ
バラ	バラ
族	ゾク
ひく	ヒク
メッセージ	メッセージ
作れる	ツクレル
帰れる	カエレル
支える	ササエル
殺害	サツガイ
リスト	リスト
ボブ	ボブ
感動	カンドウ
五郎	ゴロウ
告白	コクハク
イエス	イエス
もと	モト
誇り	ホコリ
注目	チュウモク
恋愛	レンアイ
たとえ	タトエ
女子生徒	ジョシセイト
技	ワザ
社会	シャカイ
オペ	オペ
アイデア	アイデア
ヵ月	ヵガツ
ライブ	ライブ
牛	ウシ
班	ハン
リア	リア
騒ぎ	サワギ
晩	バン
機械	キカイ
誘拐	ユウカイ
ナツ	ナツ
不明	フメイ
人形	ニンギョウ
部員	ブイン
振る	フル
卒業	ソツギョウ
承知	ショウチ
具合	グアイ
暑い	アツイ
てん	テン
太陽	タイヨウ
炎	ホノオ
局	キョク
馬場	ババ
ルー	ルー
エネルギー	エネルギー
キー	キー
わざわざ	ワザワザ
門	モン
探る	サグル
通す	トウス
話し合う	ハナシアウ
予想	ヨソウ
新聞	シンブン
勘違い	カンチガイ
マシ	マシ
どんどん	ドンドン
仕業	シワザ
目の前	メノマエ
怖がる	コワガル
低い	ヒクイ
いたむ	イタム
バンド	バンド
中止	チュウシ
趣味	シュミ
セクシー	セクシー
肩	カタ
スーパー	スーパー
さよなら	サヨナラ
霊	レイ
イス	イス
紫	ムラサキ
売れる	ウレル
未	ヒツジ
鳴る	ナル
指輪	ユビワ
さっさと	サッサト
確かめる	タシカメル
むら	ムラ
工場	コウジョウ
役に立つ	ヤクニタツ
一瞬	イッシュン
フランク	フランク
笑える	ワラエル
寄る	ヨル
燃える	モエル
若者	ワカモノ
要求	ヨウキュウ
戦士	センシ
優衣	ユウコロモ
叫ぶ	サケブ
レ	レ
通報	ツウホウ
朝食	チョウショク
スープ	スープ
だめ	ダメ
ロボット	ロボット
追い出す	オイダス
セット	セット
斬る	キル
きる	キル
ジン	ジン
床	トコ
行	ギョウ
衣装	イショウ
つきあう	ツキアウ
行為	コウイ
中身	ナカミ
あした	アシタ
それと	ソレト
発生	ハッセイ
苦しい	クルシイ
俺ら	オレラ
スピード	スピード
華	ハナ
共に	トモニ
羽	ハネ
チーズ	チーズ
賛成	サンセイ
最強	サイキョウ
しょうが	ショウガ
容疑者	ヨウギシャ
アリ	アリ
浮気	ウワキ
明らか	アキラカ
評価	ヒョウカ
不可能	フカノウ
いかが	イカガ
修理	シュウリ
環境	カンキョウ
系	ケイ
斗	ト
クリス	クリス
国民	コクミン
運	ウン
乃	ノ
ペ	ペ
ステージ	ステージ
世界中	セカイジュウ
米国	ベイコク
凛	リン
に対して	ニタイシテ
やってくる	ヤッテクル
閉じる	トジル
よこす	ヨコス
ロンドン	ロンドン
亜	ア
負け	マケ
語る	カタル
衝撃	ショウゲキ
隊員	タイイン
光栄	コウエイ
全力	ゼンリョク
っていうか	ッテイウカ
ロビン	ロビン
パリ	パリ
トラック	トラック
恥	ハジ
時々	トキドキ
いちばん	イチバン
と共に	トトモニ
お疲れさま	オツカレサマ
建物	タテモノ
よいしょ	ヨイショ
狙い	ネライ
イメージ	イメージ
たまる	タマル
一度	イチド
ポール	ポール
ゾロ	ゾロ
メキシコ	メキシコ
くそ	クソ
やん	ヤン
鈴	スズ
アレックス	アレックス
虫	ムシ
安い	ヤスイ
さっさ	サッサ
どうやら	ドウヤラ
当たり前	アタリマエ
故郷	コキョウ
セリフ	セリフ
銀行	ギンコウ
演技	エンギ
チョコ	チョコ
ノア	ノア
正義	セイギ
つなぐ	ツナグ
紙	カミ
礼	レイ
そろう	ソロウ
ジャ	ジャ
友	トモ
同時に	ドウジニ
グループ	グループ
それぞれ	ソレゾレ
きれる	キレル
に対する	ニタイスル
タバコ	タバコ
時期	ジキ
恐らく	オソラク
暴力	ボウリョク
ゴースト	ゴースト
怪物	カイブツ
ずいぶん	ズイブン
たび	タビ
健康	ケンコウ
おとなしい	オトナシイ
騒ぐ	サワグ
許せる	ユルセル
ピザ	ピザ
遠慮	エンリョ
鏡	カガミ
リサ	リサ
琴	コン
閉める	シメル
支配	シハイ
こんばんは	コンバンハ
西	ニシ
交換	コウカン
挨拶	アイサツ
熱	ネツ
拾う	ヒロウ
ぶり	ブリ
えと	エト
どっか	ドッカ
ゴミ	ゴミ
疲れ	ツカレ
褒める	ホメル
白い	シロイ
んじゃ	ンジャ
刀	カタナ
冷静	レイセイ
雰囲気	フンイキ
資料	シリョウ
センチ	センチ
タイ	タイ
センター	センター
警告	ケイコク
ヤン	ヤン
帽子	ボウシ
差	サ
型	カタ
量	リョウ
ならば	ナラバ
か月	カガツ
うそ	ウソ
転送	テンソウ
降る	フル
願い	ネガイ
地下	チカ
こる	コル
不満	フマン
死亡	シボウ
アナ	アナ
お兄さん	オニイサン
去年	キョネン
復讐	フクシュウ
里	サト
ジェームズ	ジェームズ
頼る	タヨル
正気	ショウキ
捜査官	ソウサカン
化	カ
いま	イマ
黒い	クロイ
サッカー	サッカー
うむ	ウム
噂	ウワサ
ご存じ	ゴゾンジ
フー	フー
戦闘	セントウ
短い	ミジカイ
とっても	トッテモ
事態	ジタイ
お客さん	オキャクサン
野菜	ヤサイ
限る	カギル
ちゅう	チュウ
コーチ	コーチ
ぶつかる	ブツカル
頼み	タノミ
魔女	マジョ
岩	イワ
越える	コエル
まだまだ	マダマダ
お店	オミセ
マリ	マリ
すまん	スマン
審判	シンパン
変更	ヘンコウ
訪れる	オトズレル
静か	シズカ
買い物	カイモノ
市民	シミン
可愛い	カワイ
大量	タイリョウ
自転車	ジテンシャ
民	タミ
作家	サッカ
背中	セナカ
侵入	シンニュウ
注文	チュウモン
連邦	レンポウ
いよいよ	イヨイヨ
表現	ヒョウゲン
運転手	ウンテンシュ
シャワー	シャワー
スパイ	スパイ
すら	スラ
決定	ケッテイ
とう	トウ
初め	ハジメ
罰	バツ
ニック	ニック
一応	イチオウ
繰り返す	クリカエス
詳しい	クワシイ
吉	キチ
試験	シケン
米	コメ
検事	ケンジ
タクシー	タクシー
確実	カクジツ
士	サムライ
演奏	エンソウ
ロン	ロン
塗る	ヌル
かう	カウ
泊まる	トマル
自慢	ジマン
次第	シダイ
幽い	ユウイ
自身	ジシン
高	タカ
張る	ハル
明るい	アカルイ
何と	ナント
おいおい	オイオイ
大佐	タイサ
来週	ライシュウ
おじいちゃん	オジイチャン
届ける	トドケル
会場	カイジョウ
天使	テンシ
駄目	ダメ
おや	オヤ
こうやって	コウヤッテ
ご飯	ゴメシ
贈り物	オクリモノ
焦る	アセル
ショック	ショック
運動	ウンドウ
復活	フッカツ
目覚める	メザメル
紅	クレナイ
ブラック	ブラック
半	ハン
話題	ワダイ
ウォン	ウォン
随分	ズイブン
マイ	マイ
道具	ドウグ
抱える	ダエル
日間	ニチカン
警備	ケイビ
麻薬	マヤク
性格	セイカク
勘弁	カンベン
何もかも	ナニモカモ
テーマ	テーマ
アイス	アイス
ブルー	ブルー
めっちゃ	メッチャ
大体	ダイタイ
ビデオ	ビデオ
ブルマ	ブルマ
ネズミ	ネズミ
閉まる	シマル
あんなに	アンナニ
開発	カイハツ
真剣	シンケン
バイト	バイト
偉大	イダイ
お姉ちゃん	オネエチャン
おしまい	オシマイ
地域	チイキ
対決	タイケツ
抑える	オサエル
社員	シャイン
すか	スカ
ねぇ	ネェ
向く	ムク
遠く	トオク
夢中	ムチュウ
なのだ	ナノダ
幽霊	ユウレイ
ホ	ホ
葉	ハ
扱う	アツカウ
歓迎	カンゲイ
嵐	アラシ
タイミング	タイミング
依頼	イライ
動画	ドウガ
山岡	ヤマオカ
玉	タマ
恋しい	コイシイ
うわさ	ウワサ
ありがたい	アリガタイ
相棒	アイボウ
五	ゴ
野	ノ
結ぶ	ムスブ
ハル	ハル
実力	ジツリョク
住所	ジュウショ
借金	シャッキン
波	ナミ
ロシア	ロシア
子ども	コドモ
エド	エド
決まり	キマリ
つば	ツバ
泥棒	ドロボウ
ガス	ガス
この先	コノサキ
案	アン
奥様	オクサマ
管理	カンリ
議員	ギイン
頂く	イタダク
科学	カガク
じき	ジキ
割	ワリ
田中	タナカ
ミン	ミン
一つ	ヒトツ
独り	ヒトリ
さい	サイ
緑	ミドリ
以内	イナイ
時計	トケイ
金田一	キンダイチ
票	ヒョウ
ライト	ライト
宮	ミヤ
同僚	ドウリョウ
員	イン
ノック	ノック
下りる	オリル
デザイン	デザイン
訳	ワケ
ねー	ネー
続き	ツヅキ
ジェイ	ジェイ
ジョージ	ジョージ
方向	ホウコウ
野球	ヤキュウ
香	カオリ
お嬢様	オジョウサマ
にくい	ニクイ
予約	ヨヤク
匂い	ニオイ
バン	バン
安	アン
ていう	テイウ
文化	ブンカ
おかえり	オカエリ
なか	ナカ
否定	ヒテイ
心から	ココロカラ
シーン	シーン
なんとか	ナントカ
人質	ヒトジチ
相当	ソウトウ
迫る	セマル
通じる	ツウジル
七	シチ
ソース	ソース
まとめる	マトメル
ソ	ソ
ダム	ダム
着替える	キガエル
村人	ムラビト
わざと	ワザト
インド	インド
叫び声	サケビコエ
産む	ウム
まいる	マイル
種類	シュルイ
基地	キチ
そっくり	ソックリ
お世話	オセワ
警部	ケイブ
大金	タイキン
年生	ネンセイ
桜木	サクラギ
地元	ジモト
ため息	タメイキ
正確	セイカク
輝く	カガヤク
遅刻	チコク
幼い	オサナイ
動ける	ウゴケル
相変わらず	アイカワラズ
すく	スク
妖精	ヨウセイ
代わり	カワリ
いい感じ	イイカンジ
ハート	ハート
ナイフ	ナイフ
ポ	ポ
余裕	ヨユウ
裸	ハダカ
非常に	ヒジョウニ
バッグ	バッグ
始まり	ハジマリ
セ	セ
まとも	マトモ
キレイ	キレイ
チェック	チェック
品	ヒン
電気	デンキ
ノー	ノー
ランチ	ランチ
カット	カット
クズ	クズ
かつて	カツテ
片づける	カタヅケル
ポンド	ポンド
もので	モノデ
捜索	ソウサク
いらっしゃい	イラッシャイ
ほぼ	ホボ
よーし	ヨーシ
階段	カイダン
シシ	シシ
チョッパー	チョッパー
係	カカリ
はーい	ハーイ
理	リ
比べる	クラベル
トーマス	トーマス
知らせ	シラセ
せき	セキ
宗	シュウ
阿良	アリョウ
クマ	クマ
利く	キク
週	シュウ
ご主人	ゴシュジン
実に	ジツニ
保護	ホゴ
田村	タムラ
渡る	ワタル
見た目	ミタメ
塩	シオ
駅	エキ
あぁ	アァ
上司	ジョウシ
下げる	サゲル
提供	テイキョウ
代わる	カワル
少佐	ショウサ
そもそも	ソモソモ
来	ライ
招く	マネク
ミスター	ミスター
本日	ホンジツ
カー	カー
広がる	ヒロガル
楽しめる	タノシメル
危機	キキ
せめて	セメテ
日々	ヒビ
空港	クウコウ
追いかける	オイカケル
下手	ヘタ
りん	リン
市	シ
停止	テイシ
招待	ショウタイ
なー	ナー
ですが	デスガ
エリック	エリック
グレイ	グレイ
つけ	ツケ
お腹	オハラ
レストラン	レストラン
生物	セイブツ
全体	ゼンタイ
市長	シチョウ
きみ	キミ
好み	コノミ
意外	イガイ
パス	パス
至	イタ
拳	コブシ
チー	チー
ようやく	ヨウヤク
政治	セイジ
信	シン
手段	シュダン
英雄	エイユウ
自宅	ジタク
すっかり	スッカリ
どける	ドケル
お祝い	オイワイ
歌手	カシュ
イギリス	イギリス
仲良く	ナカヨク
感覚	カンカク
いいかげん	イイカゲン
君ら	クンラ
郎	ロウ
団	ダン
看護師	カンゴシ
精神	セイシン
優	ユウ
世紀	セイキ
ボタン	ボタン
ネコ	ネコ
ケン	ケン
ブロック	ブロック
通う	カヨウ
キョン	キョン
あふれる	アフレル
近所	キンジョ
出演	シュツエン
豆	マメ
教育	キョウイク
まつ	マツ
さる	サル
備える	ソナエル
週末	シュウマツ
操る	アヤツル
ぶっ	ブッ
サイズ	サイズ
伝わる	ツタワル
男子生徒	ダンシセイト
読める	ヨメル
デ	デ
マックス	マックス
賭ける	カケル
申す	モウス
バイク	バイク
ウィル	ウィル
言い訳	イイワケ
踏む	フム
けれど	ケレド
分ける	ワケル
分析	ブンセキ
テーブル	テーブル
最終	サイシュウ
ラン	ラン
あらゆる	アラユル
浴びる	アビル
桑原	クワハラ
体験	タイケン
終える	オエル
主張	シュチョウ
旦那	ダンナ
対応	タイオウ
増田	マスダ
過ち	アヤマチ
取材	シュザイ
導く	ミチビク
何より	ナニヨリ
背	セ
生かす	イカス
標的	ヒョウテキ
伝言	デンゴン
おっしゃる	オッシャル
埋める	ウメル
言い方	イイカタ
嫉妬	シット
バカ野郎	バカヤロウ
ほっとく	ホットク
金持ち	カネモチ
アイドル	アイドル
メニュー	メニュー
腰	コシ
冷蔵庫	レイゾウコ
気の毒	キノドク
経つ	ヘツ
角	カク
佐藤	サトウ
イタリア	イタリア
尊敬	ソンケイ
ジュニア	ジュニア
パンツ	パンツ
鬼太郎	キタロウ
コース	コース
撃てる	ウテル
ドラマ	ドラマ
乗り越える	ノリコエル
持てる	モテル
訪ねる	タズネル
雲	クモ
信号	シンゴウ
散歩	サンポ
衣	コロモ
見捨てる	ミステル
ルーク	ルーク
すると	スルト
地上	チジョウ
始末	シマツ
額	ヒタイ
呼べる	ヨベル
パーティ	パーティ
食	ショク
だす	ダス
アリス	アリス
慎重	シンチョウ
いとこ	イトコ
タダ	タダ
かぶる	カブル
判事	ハンジ
だれ	ダレ
冴	コ
捧げる	ササゲル
あん	アン
ちょう	チョウ
公園	コウエン
目立つ	メダツ
呼吸	コキュウ
操作	ソウサ
よっしゃ	ヨッシャ
京子	キョウコ
マリア	マリア
浮かぶ	ウカブ
ウェイ	ウェイ
ビビる	ビビル
ストレス	ストレス
エル	エル
スポーツ	スポーツ
孤独	コドク
ひと言	ヒトゲン
抵抗	テイコウ
ピッコロ	ピッコロ
パートナー	パートナー
強盗	ゴウトウ
連れて	ツレテ
候補	コウホ
袋	フクロ
やす	ヤス
早速	サッソク
ビジネス	ビジネス
加減	カゲン
作り	ツクリ
江	コウ
変身	ヘンシン
商売	ショウバイ
商品	ショウヒン
次元	ジゲン
にゃ	ニャ
ハン	ハン
世の中	ヨノナカ
勝者	ショウシャ
医療	イリョウ
緊急	キンキュウ
発言	ハツゲン
クール	クール
地図	チズ
追跡	ツイセキ
真面目	マジメ
果たす	ハタス
そら	ソラ
合格	ゴウカク
サンタ	サンタ
見張る	ミハル
ご覧	ゴラン
救急車	キュウキュウシャ
変態	ヘンタイ
ただし	タダシ
ウー	ウー
映る	ウツル
思いつく	オモイツク
ふさわしい	フサワシイ
自由に	ジユウニ
ナ	ナ
スコット	スコット
今でも	イマデモ
殺し	コロシ
どんなに	ドンナニ
別れ	ワカレ
王妃	オウヒ
家庭	カテイ
空く	アク
はん	ハン
暮らし	クラシ
祖母	ソボ
不要	フヨウ
支援	シエン
騎士	キシ
無実	ムジツ
ダニー	ダニー
恐竜	キョウリュウ
チキン	チキン
魔力	マリョク
安定	アンテイ
休憩	キュウケイ
モー	モー
帰り	カエリ
エリカ	エリカ
ほんとに	ホントニ
割れる	ワレル
天国	テンゴク
展開	テンカイ
派	ハ
言	ゲン
黒子	クロコ
誰でも	ダレデモ
計算	ケイサン
買える	カエル
李	スモモ
食料	ショクリョウ
ゆき	ユキ
喜び	ヨロコビ
勝手に	カッテニ
おごる	オゴル
狭い	セマイ
草	クサ
診る	ミル
飲み物	ノミモノ
大志	タイシ
嬢さん	ジョウサン
登る	ノボル
秘書	ヒショ
鉄	テツ
カレン	カレン
ライアン	ライアン
両方	リョウホウ
教室	キョウシツ
たく	タク
お菓子	オカシ
琴子	コンコ
プール	プール
がん	ガン
ソウル	ソウル
拒否	キョヒ
折れる	オレル
本部	ホンブ
救える	スクエル
返せる	カエセル
うなり声	ウナリコエ
普段	フダン
牙	キバ
休暇	キュウカ
官	カン
イベント	イベント
引っ張る	ヒッパル
英国	エイコク
回収	カイシュウ
用件	ヨウケン
投票	トウヒョウ
美雪	ミユキ
魅力	ミリョク
トラ	トラ
移る	ウツル
理想	リソウ
艦隊	カンタイ
バカげる	バカゲル
専門家	センモンカ
放送	ホウソウ
資金	シキン
既に	スデニ
ツアー	ツアー
バイバイ	バイバイ
冒険	ボウケン
単純	タンジュン
宝	タカラ
亀	カメ
逃す	ノガス
流れ	ナガレ
及ぶ	オヨブ
証人	ショウニン
材料	ザイリョウ
チャック	チャック
機能	キノウ
すっごい	スッゴイ
出番	デバン
審査員	シンサイン
助言	ジョゲン
チョン	チョン
いたい	イタイ
もしか	モシカ
校長	コウチョウ
豚	ブタ
乱	ラン
吉田	ヨシダ
フフ	フフ
フランキー	フランキー
カリフォルニア	カリフォルニア
パイ	パイ
手下	テシタ
確保	カクホ
一気に	イッキニ
悔しい	クヤシイ
閉じ込める	トジコメル
谷	タニ
実現	ジツゲン
巨人	キョジン
神父	シンプ
かる	カル
囚人	シュウジン
友情	ユウジョウ
生き残る	イキノコル
ひとり	ヒトリ
痛む	イタム
出来事	デキゴト
らっしゃる	ラッシャル
ものすごい	モノスゴイ
リック	リック
演じる	エンジル
接触	セッショク
まく	マク
もんか	モンカ
魔王	マオウ
ゆ	ユ
住民	ジュウミン
肌	ハダ
外れる	ハズレル
線	セン
ハグ	ハグ
驚き	オドロキ
サービス	サービス
下ろす	クダロス
岡部	オカベ
皿	サラ
オーナー	オーナー
きく	キク
解く	トク
資格	シカク
しずか	シズカ
親しい	シタシイ
スタジオ	スタジオ
カエル	カエル
世間	セケン
やれやれ	ヤレヤレ
出血	シュッケツ
俳優	ハイユウ
使用	シヨウ
ケイト	ケイト
利	リ
太る	フトル
譲る	ユズル
ないし	ナイシ
ジャンプ	ジャンプ
入院	ニュウイン
けい	ケイ
はな	ハナ
大樹	タイジュ
愚か	オロカ
スリー	スリー
汗	アセ
タイム	タイム
ジミー	ジミー
段階	ダンカイ
獣	ケモノ
見逃す	ミノガス
仁	ヒトシ
刃	ハ
脱落	ダツラク
我	ワレ
まあまあ	マアマア
術	ジュツ
ミシェル	ミシェル
戸	コ
チャイム	チャイム
業界	ギョウカイ
えい	エイ
組員	クミイン
ビックリ	ビックリ
おそい	オソイ
なくす	ナクス
対処	タイショ
湖	ミズウミ
内緒	ナイショ
あ～	ア～
この辺	コノヘン
親切	シンセツ
オフィス	オフィス
半年	ハントシ
はじめまして	ハジメマシテ
まくる	マクル
むしろ	ムシロ
なのです	ナノデス
ブタ	ブタ
プログラム	プログラム
ハチ	ハチ
よー	ヨー
カップル	カップル
不幸	フコウ
惑星	ワクセイ
狩り	カリ
シャッター	シャッター
世界一	セカイイチ
タカ	タカ
じっと	ジット
艦	カン
預かる	アズカル
きり	キリ
懐かしい	ナツカシイ
つね	ツネ
呪い	ノロイ
女優	ジョユウ
シュート	シュート
に関する	ニカンスル
ホッ	ホッ
造	ゾウ
素敵	ステキ
縁	ヘリ
割る	ワル
やる気	ヤルキ
深刻	シンコク
犯罪者	ハンザイシャ
そこから	ソコカラ
込める	コメル
用事	ヨウジ
加藤	カトウ
それにしても	ソレニシテモ
光る	ヒカル
大げさ	オオゲサ
職場	ショクバ
スタイル	スタイル
ラジオ	ラジオ
空間	クウカン
衝突	ショウトツ
ほえる	ホエル
おば	オバ
ベスト	ベスト
待機	タイキ
知識	チシキ
リスク	リスク
パソコン	パソコン
みりん	ミリン
利益	リエキ
惜しい	オシイ
表情	ヒョウジョウ
詳しく	クワシク
いただける	イタダケル
懸ける	カケル
青い	アオイ
知れる	シレル
出ろ	デロ
特定	トクテイ
姉妹	シマイ
テープ	テープ
誰か	ダレカ
投資	トウシ
情熱	ジョウネツ
仕掛ける	シカケル
同然	ドウゼン
落ち込む	オチコム
らん	ラン
カール	カール
薫	カオル
祝う	イワウ
処分	ショブン
守れる	マモレル
タマ	タマ
慌てる	アワテル
ダニエル	ダニエル
際	キワ
寝室	シンシツ
藤	フジ
キャンプ	キャンプ
チン	チン
突っ込む	ツッコム
陽	ヨウ
魅力的	ミリョクテキ
ヘンリー	ヘンリー
ダイアナ	ダイアナ
郡	グン
作	サク
弥勒	ミロク
泳ぐ	オヨグ
ふーん	フーン
選挙	センキョ
学	ガク
ぼう	ボウ
ウソつき	ウソツキ
処理	ショリ
じゃう	ジャウ
風邪	カゼ
ルイス	ルイス
無い	ナイ
もはや	モハヤ
笑い	ワライ
ブラ	ブラ
まえる	マエル
ヘビ	ヘビ
菜	ナ
タン	タン
かねる	カネル
よくも	ヨクモ
味わう	アジワウ
寅	トラ
マル	マル
宿題	シュクダイ
殺せる	コロセル
屋敷	ヤシキ
しょ	ショ
先週	センシュウ
時半	ジハン
たろう	タロウ
植物	ショクブツ
アンナ	アンナ
文字	モジ
皇帝	コウテイ
クレア	クレア
キツ	キツ
クッキー	クッキー
温かい	オンカイ
一切	イッサイ
襲撃	シュウゲキ
ロバート	ロバート
大尉	タイイ
ごはん	ゴハン
さようなら	サヨウナラ
行方不明	ユクエフメイ
エマ	エマ
アダム	アダム
ウサギ	ウサギ
ジュリアン	ジュリアン
獲物	エモノ
モンスター	モンスター
主人	シュジン
名誉	メイヨ
カイ	カイ
お父様	オトウサマ
そちら	ソチラ
崎	サキ
感染	カンセン
署	ショ
休み	ヤスミ
習う	ナラウ
青葉	アオバ
うえ	ウエ
数える	カゾエル
セル	セル
今田	イマダ
獲得	カクトク
ライン	ライン
食らう	クラウ
頼り	タヨリ
たっぷり	タップリ
ピアノ	ピアノ
シーズン	シーズン
皮	カワ
表	オモテ
従業員	ジュウギョウイン
そのよう	ソノヨウ
悲しみ	カナシミ
麻	アサ
サル	サル
飾る	カザル
ある日	アルニチ
シャツ	シャツ
ボー	ボー
雷	カミナリ
疑問	ギモン
生命	セイメイ
数字	スウジ
お別れ	オワカレ
土	ツチ
治す	ナオス
悩み	ナヤミ
載せる	ノセル
がれ	ガレ
よす	ヨス
パブ	パブ
娘さん	ムスメサン
避難	ヒナン
げん	ゲン
個人的	コジンテキ
悪党	アクトウ
めい	メイ
意思	イシ
今さら	イマサラ
松本	マツモト
載る	ノル
賞	ショウ
下着	シタギ
辛い	ツライ
吹く	フク
素直	スナオ
コード	コード
出会い	デアイ
ざわめき	ザワメキ
中心	チュウシン
あく	アク
刺激	シゲキ
誕生	タンジョウ
リリー	リリー
接近	セッキン
桜	サクラ
かまう	カマウ
だいぶ	ダイブ
飛	ヒ
恨む	ウラム
グリーン	グリーン
釈放	シャクホウ
ヘリ	ヘリ
派手	ハデ
ウイルス	ウイルス
着ける	ツケル
バスケ	バスケ
石田	イシダ
奴隷	ドレイ
かれる	カレル
牧師	ボクシ
詩	シ
ウワサ	ウワサ
血圧	ケツアツ
クイーン	クイーン
保証	ホショウ
同意	ドウイ
国家	コッカ
マネージャー	マネージャー
巻く	マク
賞金	ショウキン
おっさん	オッサン
規則	キソク
この間	コノカン
咲	サキ
九	キュウ
雑誌	ザッシ
悪夢	アクム
ドラッグ	ドラッグ
再会	サイカイ
課題	カダイ
ガ	ガ
本来	ホンライ
勇敢	ユウカン
手配	テハイ
列車	レッシャ
混ぜる	マゼル
奈落	ナラク
霧	キリ
飼う	カウ
パック	パック
りゅう	リュウ
上原	ウエハラ
副	フク
選択肢	センタクシ
無関係	ムカンケイ
公	コウ
応答	オウトウ
飽きる	アキル
決勝	ケッショウ
給料	キュウリョウ
被害	ヒガイ
症状	ショウジョウ
飛ばす	トバス
プレー	プレー
伏せる	フセル
無	ム
しつこい	シツコイ
へっ	ヘッ
堂	ドウ
役目	ヤクメ
メモ	メモ
祖父	ソフ
やく	ヤク
負う	オウ
偉い	エライ
恵	メグミ
音声	オンセイ
エース	エース
ハメ	ハメ
双子	フタゴ
砂	スナ
幻	マボロシ
確信	カクシン
バック	バック
毎年	マイトシ
午前	ゴゼン
さらす	サラス
器	ウツワ
ゲスト	ゲスト
ハー	ハー
パイロット	パイロット
児	ジ
課	カ
トミー	トミー
ジュース	ジュース
エミリー	エミリー
プロデューサー	プロデューサー
沙子	サコ
あいさつ	アイサツ
こむ	コム
悲しむ	カナシム
少なくとも	スクナクトモ
押さえる	オサエル
捕らえる	トラエル
由	ユ
学園	ガクエン
引っ越す	ヒッコス
護衛	ゴエイ
助手	ジョシュ
えむ	エム
灰	ハイ
連続	レンゾク
いむ	イム
佐	サ
王国	オウコク
蓮	ハス
ウチ	ウチ
贈る	オクル
上条	カミジョウ
嬉しい	ウレシイ
女房	ニョウボウ
沈む	シズム
キッチン	キッチン
ウフッ	ウフッ
トランクス	トランクス
両	リョウ
一族	イチゾク
わずか	ワズカ
結衣	ケツコロモ
グレン	グレン
司令官	シレイカン
もともと	モトモト
全国	ゼンコク
テロ	テロ
夜中	ヨナカ
ファ	ファ
土方	ドカタ
ものか	モノカ
動揺	ドウヨウ
手遅れ	テオクレ
たす	タス
バリー	バリー
勝	カチ
せずに	セズニ
美咲	ビサキ
ローズ	ローズ
囲む	カコム
年齢	ネンレイ
積む	ツム
ワープ	ワープ
トニー	トニー
モン	モン
整理	セイリ
諸君	ショクン
付き	ツキ
伝統	デントウ
やり直す	ヤリナオス
一度も	イチドモ
法律	ホウリツ
ギャング	ギャング
感	カン
追加	ツイカ
アナウンサー	アナウンサー
長年	ナガネン
昼	ヒル
爆破	バクハ
貴重	キチョウ
だり	ダリ
市場	シジョウ
成績	セイセキ
解除	カイジョ
メシ	メシ
包む	ツツム
報酬	ホウシュウ
飲める	ノメル
ビッグ	ビッグ
引退	インタイ
教わる	オシワル
歩ける	アルケル
強力	キョウリョク
マット	マット
墓	ハカ
入江	イリエ
毛	ケ
闘う	タタカウ
切	セツ
ヒゲ	ヒゲ
伸ばす	ノバス
外出	ガイシュツ
適当	テキトウ
更に	サラニ
署名	ショメイ
探偵	タンテイ
アナウンス	アナウンス
キャプテン	キャプテン
桂	カツラ
ジョーク	ジョーク
意志	イシ
違法	イホウ
リチャード	リチャード
エドワード	エドワード
犯	ハン
新人	シンジン
狼	オオカミ
絆	キズナ
ブライアン	ブライアン
ヤク	ヤク
建てる	タテル
りょう	リョウ
死者	シシャ
ページ	ページ
達也	タツヤ
けども	ケドモ
サプライズ	サプライズ
広げる	ヒロゲル
謝罪	シャザイ
都合	ツゴウ
キャラ	キャラ
ホイッスル	ホイッスル
しまる	シマル
エリザベス	エリザベス
ラウンド	ラウンド
各	カク
課長	カチョウ
警備員	ケイビイン
おーい	オーイ
わい	ワイ
問う	トウ
おもい	オモイ
底	ソコ
コール	コール
士郎	シロウ
帝国	テイコク
電車	デンシャ
あまりに	アマリニ
事業	ジギョウ
対象	タイショウ
泉	イズミ
署長	ショチョウ
ビリー	ビリー
悠	ユウ
蔵	クラ
パーセント	パーセント
戦場	センジョウ
サイ	サイ
今や	イマヤ
大麻	タイマ
オヤジ	オヤジ
店長	テンチョウ
無線	ムセン
職員	ショクイン
見つめる	ミツメル
そのもの	ソノモノ
ってな	ッテナ
砂糖	サトウ
かつ	カツ
兵器	ヘイキ
仙人	センニン
権力	ケンリョク
警戒	ケイカイ
において	ニオイテ
クリア	クリア
移す	ウツス
メス	メス
企業	キギョウ
店主	テンシュ
速度	ソクド
手伝い	テツダイ
ゆり	ユリ
儀式	ギシキ
菜緒	ナオ
ローマ	ローマ
今週	コンシュウ
ごらん	ゴラン
地面	ジメン
含む	フクム
修行	シュギョウ
わり	ワリ
目玉	メダマ
集団	シュウダン
あい	アイ
チビ	チビ
縛る	シバル
面会	メンカイ
もたらす	モタラス
主任	シュニン
長官	チョウカン
実家	ジッカ
詳細	ショウサイ
合図	アイズ
挑む	イドム
故障	コショウ
調整	チョウセイ
ドット	ドット
お邪魔	オジャマ
じい	ジイ
経営	ケイエイ
阻止	ソシ
保安官	ホアンカン
警察官	ケイサツカン
鳴子	ナルコ
攻める	セメル
燃やす	モヤス
実行	ジッコウ
火事	カジ
ズボン	ズボン
わる	ワル
間違いなく	マチガイナク
あむ	アム
同情	ドウジョウ
和	ワ
闘士	トウシ
アパート	アパート
腐る	クサル
サイト	サイト
小野田	オノダ
コート	コート
トラブル	トラブル
度目	ドメ
生まれ	ウマレ
アップ	アップ
ラッキー	ラッキー
黄金	オウゴン
そのうち	ソノウチ
マキ	マキ
制服	セイフク
翼	ツバサ
追いつく	オイツク
クルー	クルー
ローリー	ローリー
勢い	イキオイ
座	ザ
老人	ロウジン
やむ	ヤム
ホンマ	ホンマ
今頃	イマゴロ
からかう	カラカウ
困難	コンナン
面接	メンセツ
果たして	ハタシテ
枝	エダ
説明し	セツメイシ
ノリ	ノリ
ベイビー	ベイビー
レベッカ	レベッカ
油断	ユダン
再	サイ
ふり	フリ
レオ	レオ
暴れる	アバレル
処刑	ショケイ
掘る	ホル
芝居	シバイ
保つ	タモツ
モノ	モノ
おびえる	オビエル
大切に	タイセツニ
正常	セイジョウ
裏切り者	ウラギリモノ
設定	セッテイ
開閉	カイヘイ
主役	シュヤク
きゅう	キュウ
並ぶ	ナラブ
字	ジ
だいじょうぶ	ダイジョウブ
おじ	オジ
個人	コジン
満ちる	ミチル
メガネ	メガネ
婚約	コンヤク
ヨ	ヨ
ジュン	ジュン
つつ	ツツ
世代	セダイ
築く	キヅク
おまえ	オマエ
ベイ	ベイ
小僧	コゾウ
えらい	エライ
対策	タイサク
あきらめる	アキラメル
だし	ダシ
ロー	ロー
下す	クダス
感想	カンソウ
かなえる	カナエル
別人	ベツジン
地区	チク
くだらない	クダラナイ
失望	シツボウ
依頼人	イライニン
顧客	コキャク
いったい	イッタイ
チケット	チケット
悲劇	ヒゲキ
指紋	シモン
活躍	カツヤク
ボート	ボート
伸びる	ノビル
ほれる	ホレル
也	ヤ
お断り	オコトワリ
倉庫	ソウコ
話しかける	ハナシカケル
一家	イッカ
おと	オト
そうやって	ソウヤッテ
今泉	イマイズミ
増やす	フヤス
見かける	ミカケル
物音	モノオト
じゅう	ジュウ
エサ	エサ
メイン	メイン
犯行	ハンコウ
進化	シンカ
カレー	カレー
ご苦労	ゴクロウ
瞬	シュン
親子	オヤコ
弾く	ヒク
法廷	ホウテイ
お風呂	オフロ
とっと	トット
ボビー	ボビー
ライバル	ライバル
あう	アウ
興味深い	キョウミブカイ
現金	ゲンキン
光希	ミキ
見守る	ミマモル
責任者	セキニンシャ
サメ	サメ
中央	チュウオウ
忠告	チュウコク
苦しみ	クルシミ
カナダ	カナダ
無用	ムヨウ
続いて	ツヅイテ
覚ます	サマス
人殺し	ヒトゴロシ
ギター	ギター
章	ショウ
油	アブラ
イケメン	イケメン
優先	ユウセン
一生懸命	イッショウケンメイ
お楽しみ	オタノシミ
ユダヤ人	ユダヤニン
争う	アラソウ
偉そう	エラソウ
盛り上がる	モリアガル
予感	ヨカン
デザート	デザート
建設	ケンセツ
ナイス	ナイス
同感	ドウカン
女神	メガミ
棒	ボウ
気持ちいい	キモチイイ
芸術	ゲイジュツ
ハウス	ハウス
ばっか	バッカ
手がかり	テガカリ
おかしな	オカシナ
こわい	コワイ
フラ	フラ
交代	コウタイ
珊瑚	サンゴ
六	ロク
球	タマ
色々	イロイロ
なめる	ナメル
陽子	ヨウコ
シカゴ	シカゴ
ベルト	ベルト
公開	コウカイ
舌	シタ
出口	デグチ
大きさ	オオキサ
食材	ショクザイ
高級	コウキュウ
犠牲者	ギセイシャ
科学者	カガクシャ
防ぐ	フセグ
済み	スミ
奇妙	キミョウ
帰す	カエス
海外	カイガイ
突入	トツニュウ
級	キュウ
生き物	イキモノ
ある人	アルニン
ジュリア	ジュリア
放せる	ハナセル
ついで	ツイデ
わたくし	ワタクシ
ぶつ	ブツ
愛情	アイジョウ
ごとし	ゴトシ
オー	オー
職人	ショクニン
大地	ダイチ
大将	タイショウ
セイバー	セイバー
義務	ギム
バランス	バランス
アウト	アウト
どる	ドル
みな	ミナ
敬意	ケイイ
正式	セイシキ
追って	オッテ
山田	ヤマダ
なお	ナオ
ワクワク	ワクワク
復帰	フッキ
希	マレ
ピンク	ピンク
批判	ヒハン
筋肉	キンニク
預ける	アズケル
に関して	ニカンシテ
小説	ショウセツ
ケリー	ケリー
意外と	イガイト
死ねる	シネル
えーっ	エーッ
机	ツクエ
焼ける	ヤケル
造る	ツクル
ゆく	ユク
拒む	コバム
よお	ヨオ
再生	サイセイ
汚れる	ヨゴレル
震える	フルエル
王女	オウジョ
マリー	マリー
メアリー	メアリー
覚める	サメル
拘束	コウソク
解ける	トケル
逆らう	サカラウ
住人	ジュウニン
崩れる	クズレル
チップ	チップ
詰まる	ツマル
輝	テル
リアル	リアル
同様	ドウヨウ
オーストラリア	オーストラリア
きっかけ	キッカケ
フィールド	フィールド
憎む	ニクム
つまらない	ツマラナイ
やって来る	ヤッテクル
業者	ギョウシャ
指導	シドウ
逃げ出す	ニゲダス
酸素	サンソ
チャールズ	チャールズ
小野	オノ
書ける	カケル
夕	ユウ
ほんの	ホンノ
レイプ	レイプ
退院	タイイン
祝福	シュクフク
お帰り	オカエリ
台なし	ダイナシ
師	シ
ハンナ	ハンナ
ワナ	ワナ
林	ハヤシ
先日	センジツ
うまる	ウマル
きん	キン
餌	エサ
拷問	ゴウモン
マーティン	マーティン
チャップ	チャップ
崩壊	ホウカイ
ばん	バン
厄介	ヤッカイ
きちんと	キチント
くさい	クサイ
以下	イカ
知らず	シラズ
情けない	ナサケナイ
リング	リング
妃	キサキ
己	オノレ
支持	シジ
生き延びる	イキノビル
予算	ヨサン
評判	ヒョウバン
単なる	タンナル
釣り	ツリ
リオ	リオ
お姉さん	オネエサン
審査	シンサ
新鮮	シンセン
ドキドキ	ドキドキ
非難	ヒナン
大物	オオモノ
雄二	ユウジ
ご両親	ゴリョウシン
ごちそう	ゴチソウ
スペイン	スペイン
プライド	プライド
れい	レイ
待	タイ
わぁ	ワァ
大石	オオイシ
薄い	ウスイ
ファイル	ファイル
不足	フソク
再現	サイゲン
政	マツリゴト
つかまる	ツカマル
寄付	キフ
続けて	ツヅケテ
アルバム	アルバム
仮面	カメン
録音	ロクオン
その間	ソノカン
抜き	ヌキ
ハリー	ハリー
企画	キカク
命じる	メイジル
決着	ケッチャク
親分	オヤブン
リード	リード
恨み	ウラミ
リス	リス
待ち	マチ
交際	コウサイ
滑る	スベル
フォード	フォード
じん	ジン
鍛える	キタエル
始めて	ハジメテ
つう	ツウ
ミルク	ミルク
もったいない	モッタイナイ
七宝	シッポウ
呼び出す	ヨビダス
未央	ミオ
アーティスト	アーティスト
毎回	マイカイ
シ	シ
愛しい	イトシイ
ゆうべ	ユウベ
アンディ	アンディ
カギ	カギ
転ぶ	コロブ
争い	アラソイ
原	ハラ
隙	ゲキ
ここだ	ココダ
どころか	ドコロカ
アフリカ	アフリカ
かぎり	カギリ
コピー	コピー
副長	フクチョウ
貼る	ハル
弟子	デシ
ごく	ゴク
煙	ケムリ
アメリカ人	アメリカニン
ビーチ	ビーチ
役割	ヤクワリ
財布	サイフ
イン	イン
創	ソウ
ウケる	ウケル
まじ	マジ
損傷	ソンショウ
喪	モ
いじめる	イジメル
ライオン	ライオン
屋根	ヤネ
嫁	ヨメ
いっしょ	イッショ
ガラス	ガラス
クロ	クロ
ともかく	トモカク
ピーターパン	ピーターパン
印	イン
叩く	タタク
書	カキ
ジャッキー	ジャッキー
おそらく	オソラク
失踪	シッソウ
中学	チュウガク
変わり	カワリ
報告書	ホウコクショ
ランド	ランド
高校生	コウコウセイ
侮辱	ブジョク
マスク	マスク
道路	ドウロ
ラーメン	ラーメン
ドライブ	ドライブ
もしも	モシモ
恐れ	オソレ
ダサい	ダサイ
博	ヒロシ
都	ミヤコ
真ん中	マンナカ
セント	セント
履く	ハク
化け物	バケモノ
容疑	ヨウギ
結論	ケツロン
いえる	イエル
そん	ソン
成果	セイカ
持ち主	モチヌシ
留守	ルス
総	ソウ
国王	コクオウ
牧場	ボクジョウ
周囲	シュウイ
渡せる	ワタセル
スタン	スタン
トランプ	トランプ
無意味	ムイミ
お母様	オハハサマ
シールド	シールド
パンチ	パンチ
替える	カエル
苦しめる	クルシメル
母上	ハハウエ
ちなみに	チナミニ
ワシ	ワシ
病	ビョウ
ヘン	ヘン
マスコミ	マスコミ
体力	タイリョク
通常	ツウジョウ
レント	レント
初日	ショニチ
卿	キョウ
オブ	オブ
営業	エイギョウ
始め	ハジメ
あかね	アカネ
トシ	トシ
はるか	ハルカ
鳴らす	ナラス
あきる	アキル
トド	トド
それほど	ソレホド
ヒント	ヒント
出産	シュッサン
反省	ハンセイ
あかり	アカリ
どうにか	ドウニカ
ペン	ペン
牛乳	ギュウニュウ
寺	テラ
株	カブ
フウ	フウ
指揮	シキ
済ませる	スマセル
爪	ツメ
ギルド	ギルド
大臣	ダイジン
殺る	サツル
テニス	テニス
保険	ホケン
合流	ゴウリュウ
細胞	サイボウ
かばう	カバウ
ライ	ライ
秋元	アキモト
ルイ	ルイ
行き先	イキサキ
鋭い	スルドイ
汚す	ヨゴス
尋問	ジンモン
ブラジル	ブラジル
リンゴ	リンゴ
疑い	ウタガイ
カフェ	カフェ
体重	タイジュウ
稼げる	カセゲル
ボケ	ボケ
モニカ	モニカ
何とも	ナントモ
障害	ショウガイ
ユー	ユー
離せる	ハナセル
戦車	センシャ
ファイト	ファイト
ルーシー	ルーシー
出場	シュツジョウ
生意気	ナマイキ
アニメ	アニメ
戦える	タタカエル
取り	トリ
有罪	ユウザイ
アーチャー	アーチャー
田	タ
都市	トシ
かっこいい	カッコイイ
研究所	ケンキュウショ
ゴメン	ゴメン
ピッタリ	ピッタリ
応じる	オウジル
館	カン
南部	ナンブ
違反	イハン
軍人	グンジン
伺う	ウカガウ
筋	スジ
ビン	ビン
潮	シオ
やら	ヤラ
息子さん	ムスコサン
脅威	キョウイ
不	フ
嗅ぐ	カグ
策	サク
マジック	マジック
憧れる	アコガレル
本心	ホンシン
良	リョウ
港	ミナト
ブレア	ブレア
暴行	ボウコウ
表す	アラワス
見失う	ミウシナウ
この辺り	コノアタリ
宣伝	センデン
罠	ワナ
誠	マコト
回転	カイテン
食堂	ショクドウ
ブラウン	ブラウン
ゆえ	ユエ
スる	スル
勧める	ススメル
戦略	センリャク
象徴	ショウチョウ
ゴム	ゴム
嫌がる	イヤガル
宅	タク
柄	ガラ
高橋	タカハシ
ホワイト	ホワイト
マシン	マシン
あなた方	アナタホウ
悪化	アッカ
ナナ	ナナ
継ぐ	ツグ
体調	タイチョウ
パ	パ
固い	カタイ
瞳	ヒトミ
おしゃべり	オシャベリ
仲直り	ナカナオリ
閉鎖	ヘイサ
再開	サイカイ
妨害	ボウガイ
ラブ	ラブ
呪文	ジュモン
折る	オル
日本人	ニホンジン
救出	キュウシュツ
設置	セッチ
オオカミ	オオカミ
維持	イジ
じいさん	ジイサン
久しぶりに	ヒサシブリニ
宣言	センゲン
血液	ケツエキ
ところが	トコロガ
ハンター	ハンター
余	ヨ
好	コウ
条	ジョウ
やったら	ヤッタラ
渚	ナギサ
知	チ
輪	ワ
あきれる	アキレル
入り口	イリグチ
ローラ	ローラ
４つ	４ツ
やねん	ヤネン
軍隊	グンタイ
とっくに	トックニ
特徴	トクチョウ
ペニス	ペニス
支払い	シハライ
機関	キカン
こだわる	コダワル
毎晩	マイバン
エロ	エロ
コカイン	コカイン
栗田	クリタ
砂漠	サバク
ボーイ	ボーイ
背負う	セオウ
坂道	サカミチ
専門	センモン
帰国	キコク
お気に	オキニ
ナイト	ナイト
吾郎	ワレロウ
首相	シュショウ
ぶん	ブン
淳	アツシ
まっすぐ	マッスグ
お許し	オユルシ
幹部	カンブ
年寄り	トシヨリ
いかん	イカン
バトル	バトル
全身	ゼンシン
突き止める	ツキヤメル
日記	ニッキ
記念	キネン
お任せ	オマカセ
ぶつける	ブツケル
印象	インショウ
無料	ムリョウ
リラックス	リラックス
外見	ガイケン
プロポーズ	プロポーズ
太川	タカワ
根	ネ
申し上げる	モウシアゲル
絶望	ゼツボウ
婚約者	コンヤクシャ
明久	メイキュウ
バター	バター
妄想	モウソウ
景色	ケシキ
うた	ウタ
くたばる	クタバル
肉体	ニクタイ
ジャクソン	ジャクソン
倒せる	タオセル
ごちそうさま	ゴチソウサマ
やっつける	ヤッツケル
入手	ニュウシュ
目撃者	モクゲキシャ
葬式	ソウシキ
お呼び	オヨビ
生き返る	イキカエル
ポケット	ポケット
キレ	キレ
小屋	コヤ
思い出せる	オモイダセル
そんなもの	ソンナモノ
神経	シンケイ
基本	キホン
っちゅう	ッチュウ
投稿	トウコウ
明	メイ
針	ハリ
関心	カンシン
ペット	ペット
ワシントン	ワシントン
優れる	マサレル
感心	カンシン
シャー	シャー
説教	セッキョウ
なす	ナス
クリーム	クリーム
カバン	カバン
使い	ツカイ
アンド	アンド
お袋	オフクロ
プラン	プラン
待った	マッタ
猿	サル
紗	サ
ふく	フク
掛ける	カケル
賭け	カケ
農場	ノウジョウ
オス	オス
ブレーキ	ブレーキ
兄ちゃん	ニイチャン
沙織	サオリ
来年	ライネン
至る	イタル
エレベーター	エレベーター
飛び出す	トビダス
畑	ハタケ
ヨーロッパ	ヨーロッパ
立ち上がる	タチアガル
ぬう	ヌウ
家賃	ヤチン
氷河	ヒョウガ
花火	ハナビ
バルト	バルト
気まずい	キマズイ
跡	アト
銃撃	ジュウゲキ
把握	ハアク
多	タ
少々	ショウショウ
議論	ギロン
ラップ	ラップ
含める	フクメル
越す	コス
下野	シモツケ
花嫁	ハナヨメ
委員会	イインカイ
コン	コン
ブリッジ	ブリッジ
偽物	ニセモノ
名乗る	ナノル
大騒ぎ	オオサワギ
おもちゃ	オモチャ
ホン	ホン
通	トオリ
さらう	サラウ
独身	ドクシン
皆様	ミナサマ
重ねる	カサネル
ロミオ	ロミオ
引き受ける	ヒキウケル
サイモン	サイモン
フラン	フラン
尻尾	シッポ
哀れ	アワレ
山崎	ヤマザキ
ぴったり	ピッタリ
為	タメ
好く	スク
源	ゲン
本番	ホンバン
陣	ジン
電源	デンゲン
きつい	キツイ
果	カ
進出	シンシュツ
バッチリ	バッチリ
究極	キュウキョク
生む	ウム
群れ	ムレ
奈々	ナナ
エビ	エビ
アーロン	アーロン
一員	イチイン
振り返る	フリカエル
挙げる	アゲル
センス	センス
特殊	トクシュ
連れ	ツレ
シュウ	シュウ
透	トウル
いびき	イビキ
ゴー	ゴー
ハンサム	ハンサム
起動	キドウ
麺	メン
ラム	ラム
親戚	シンセキ
豊か	ユタカ
キミ	キミ
コントロール	コントロール
吸血鬼	キュウケツキ
脅迫	キョウハク
幸い	サイワイ
値段	ネダン
最善	サイゼン
長い間	ナガイカン
ガール	ガール
でかい	デカイ
ミリ	ミリ
ヤクザ	ヤクザ
動機	ドウキ
選べる	エラベル
ありゃ	アリャ
硬い	カタイ
手続き	テツヅキ
鍋	ナベ
すう	スウ
応える	コタエル
逃れる	ノガレル
スイッチ	スイッチ
プレッシャー	プレッシャー
生地	キジ
覆う	オオウ
重	ジュウ
鋼	コウ
仕える	ツカエル
男女	ダンジョ
スミス	スミス
ヒロ	ヒロ
レン	レン
乗れる	ノレル
飛行	ヒコウ
ゴールド	ゴールド
歌声	ウタゴエ
カップ	カップ
ヒトラー	ヒトラー
大声	オオゴエ
コーナー	コーナー
その場	ソノバ
タコ	タコ
洋介	ヨウスケ
暗殺	アンサツ
看守	カンシュ
いざ	イザ
つき	ツキ
だれる	ダレル
ほん	ホン
めちゃくちゃ	メチャクチャ
重大	ジュウダイ
のぞく	ノゾク
予測	ヨソク
英	エイ
機嫌	キゲン
関連	カンレン
改造	カイゾウ
目撃	モクゲキ
不良	フリョウ
念のため	ネンノタメ
メイク	メイク
サン	サン
込む	コム
意地悪	イジワル
ナンバー	ナンバー
ラボ	ラボ
シンプル	シンプル
パー	パー
弱点	ジャクテン
おもしろい	オモシロイ
づらい	ヅライ
コンピューター	コンピューター
テキサス	テキサス
たまに	タマニ
制御	セイギョ
拭く	フク
散る	チル
えな	エナ
関係者	カンケイシャ
尋ねる	タズネル
乾	イヌイ
宮殿	キュウデン
蝶	チョウ
そんなもん	ソンナモン
カーン	カーン
告げる	ツゲル
国境	コッキョウ
激突	ゲキトツ
財産	ザイサン
手放す	テバナス
ディナー	ディナー
桐	キリ
アメ	アメ
グレース	グレース
解散	カイサン
姉ちゃん	ネエチャン
直前	チョクゼン
ジェフ	ジェフ
どちらか	ドチラカ
帝	ミカド
翌日	ヨクジツ
あな	アナ
つくる	ツクル
警報	ケイホウ
中には	ナカニハ
ブル	ブル
坊	ボウ
政治家	セイジカ
母ちゃん	カアチャン
一致	イッチ
どん	ドン
武	タケシ
院	イン
その気	ソノキ
向き合う	ムキアウ
忍	ニン
義母	ギボ
グッ	グッ
晴れる	ハレル
スペース	スペース
中尉	チュウイ
帰宅	キタク
センサー	センサー
凍る	コオル
かた	カタ
名案	メイアン
６月	６ガツ
イチ	イチ
ウィリアム	ウィリアム
ひょっと	ヒョット
ブランド	ブランド
カラ	カラ
ハンク	ハンク
近づける	チカヅケル
報道	ホウドウ
満たす	ミタス
出所	シュッショ
提出	テイシュツ
最中	サイチュウ
塔	トウ
残酷	ザンコク
素人	シロウト
脈	ミャク
買収	バイシュウ
どなた	ドナタ
ハロー	ハロー
反撃	ハンゲキ
挟む	ハサム
聞こえ	キコエ
デザイナー	デザイナー
トンネル	トンネル
パーク	パーク
バラバラ	バラバラ
代理	ダイリ
海堂	ウミドウ
日曜	ニチヨウ
田舎	イナカ
要請	ヨウセイ
アテナ	アテナ
バナナ	バナナ
予想外	ヨソウガイ
償う	ツグナウ
影山	カゲヤマ
魔術	マジュツ
唇	クチビル
アジア	アジア
揺れる	ユレル
関与	カンヨ
ファッション	ファッション
カーター	カーター
ロジャー	ロジャー
やがて	ヤガテ
天気	テンキ
宿	ヤド
御	オ
満男	ミツオ
王者	オウジャ
フィリップ	フィリップ
人数	ニンズウ
注射	チュウシャ
燃料	ネンリョウ
生える	ハエル
痛	ツウ
お守り	オマモリ
様々	サマザマ
刻む	キザム
売人	バイニン
要素	ヨウソ
樹	キ
職	ショク
独立	ドクリツ
ティム	ティム
うらやましい	ウラヤマシイ
パターン	パターン
解雇	カイコ
封印	フウイン
用心	ヨウジン
観察	カンサツ
金庫	キンコ
あちこち	アチコチ
ゾウ	ゾウ
ボーナス	ボーナス
自体	ジタイ
蛍	ホタル
ケイ	ケイ
突破	トッパ
アラン	アラン
ディーン	ディーン
検討	ケントウ
ボン	ボン
むく	ムク
ロマンチック	ロマンチック
ジョニー	ジョニー
飛べる	トベル
大使	タイシ
志	ココロザシ
風呂	フロ
徹	トオル
痩せる	ヤセル
皇太子	コウタイシ
立て	タテ
協会	キョウカイ
訴訟	ソショウ
お互いに	オタガイニ
何とかして	ナントカシテ
競争	キョウソウ
薬物	ヤクブツ
詰める	ツメル
イチゴ	イチゴ
モビル	モビル
もむ	モム
ゴブリン	ゴブリン
小学校	ショウガッコウ
改善	カイゼン
大嫌い	ダイキライ
控える	ヒカエル
すい	スイ
ソファ	ソファ
巣	ス
玄関	ゲンカン
勇者	ユウシャ
堂々	ドウドウ
根拠	コンキョ
ルート	ルート
桃子	モモコ
衛	マモル
当	トウ
起訴	キソ
長谷川	ハセガワ
プロジェクト	プロジェクト
フェ	フェ
だからこそ	ダカラコソ
ユーリ	ユーリ
２人きり	２ニンキリ
お似合い	オニアイ
防御	ボウギョ
オーディション	オーディション
ロープ	ロープ
互い	タガイ
像	ゾウ
大胆	ダイタン
異議	イギ
レオン	レオン
勘	カン
有名人	ユウメイジン
前進	ゼンシン
メイド	メイド
太い	フトイ
グラス	グラス
祈り	イノリ
まね	マネ
更	コウ
飛び込む	トビコム
キャロル	キャロル
ケース	ケース
ビュー	ビュー
破滅	ハメツ
おじいさん	オジイサン
ラス	ラス
磨く	ミガク
鶏	ニワトリ
うんざり	ウンザリ
井上	イノウエ
並み	ナミ
今のところ	イマノトコロ
沙	サ
身長	シンチョウ
みづき	ミヅキ
偽	ニセ
制作	セイサク
チャンピオン	チャンピオン
ジェシカ	ジェシカ
上着	ウワギ
辺り	アタリ
夫妻	フサイ
注ぐ	ソソグ
あるいは	アルイハ
撤退	テッタイ
赤木	アカギ
まして	マシテ
使命	シメイ
有利	ユウリ
食える	クエル
シティ	シティ
改めて	アラタメテ
なぜなら	ナゼナラ
問	トン
アーメン	アーメン
ごまかす	ゴマカス
指揮官	シキカン
期間	キカン
エラ	エラ
デブ	デブ
ポーズ	ポーズ
分の	フンノ
足す	タス
ルビー	ルビー
雷鳴	ライメイ
加わる	クワワル
アート	アート
ツイ	ツイ
オープン	オープン
さく	サク
宗教	シュウキョウ
雄大	ユウダイ
ツー	ツー
次々	ツギツギ
ベラ	ベラ
イライラ	イライラ
しゅう	シュウ
よそ	ヨソ
純粋	ジュンスイ
エリア	エリア
４月	４ガツ
洗濯	センタク
頼める	タノメル
潜入	センニュウ
笑わせる	ワラワセル
試練	シレン
屋上	オクジョウ
本田	ホンダ
殺人事件	サツジンジケン
配る	クバル
ザック	ザック
タイヤ	タイヤ
たまたま	タマタマ
チュー	チュー
パトリック	パトリック
内部	ナイブ
周	シュウ
広告	コウコク
司会	シカイ
１か月	１カガツ
サタン	サタン
職業	ショクギョウ
沖田	オキタ
費用	ヒヨウ
室長	シツチョウ
タトゥー	タトゥー
泥	ドロ
洞窟	ドウクツ
サイレン	サイレン
しとる	シトル
披露	ヒロウ
行方	ナメガタ
世子	ヨコ
発明	ハツメイ
マッサージ	マッサージ
ブルース	ブルース
廊下	ロウカ
後輩	コウハイ
支度	シタク
時点	ジテン
柔らかい	ヤワラカイ
漏れる	モレル
邪悪	ジャアク
駐車場	チュウシャジョウ
役立たず	ヤクタタズ
皮肉	ヒニク
真相	シンソウ
裁判所	サイバンショ
できるだけ	デキルダケ
ルル	ルル
めん	メン
広	コウ
矢口	ヤグチ
確率	カクリツ
悪口	ワルクチ
トマト	トマト
この前	コノマエ
まり	マリ
常	ツネ
周辺	シュウヘン
肺	ハイ
収穫	シュウカク
手塚	テヅカ
脅かす	キョウカス
何にも	ナニニモ
務める	ツトメル
成立	セイリツ
集合	シュウゴウ
メディア	メディア
二宮	ニノミヤ
死刑	シケイ
認識	ニンシキ
軌道	キドウ
退治	タイジ
骨折	コッセツ
コア	コア
さき	サキ
桔梗	キキョウ
欠ける	カケル
修復	シュウフク
光景	コウケイ
棚	タナ
スティーブ	スティーブ
不二子	フジコ
診察	シンサツ
購入	コウニュウ
台無し	ダイナシ
強化	キョウカ
排除	ハイジョ
フリー	フリー
公演	コウエン
製	セイ
追い詰める	オイツメル
鼻歌	ハナウタ
タオル	タオル
登録	トウロク
突く	ツク
羊	ヒツジ
シー	シー
差別	サベツ
ジェリー	ジェリー
ラスト	ラスト
捜せる	サガセル
眠い	ネムイ
封鎖	フウサ
電話番号	デンワバンゴウ
ねこ	ネコ
不正	フセイ
土曜	ドヨウ
強烈	キョウレツ
ストップ	ストップ
日誌	ニッシ
深呼吸	シンコキュウ
フォー	フォー
叱る	シカル
９月	９ガツ
互いに	タガイニ
全滅	ゼンメツ
気配	ケハイ
あおい	アオイ
ジョーンズ	ジョーンズ
金曜	キンヨウ
矢作	ヤハギ
通話	ツウワ
ケチ	ケチ
美女	ビジョ
信仰	シンコウ
局長	キョクチョウ
心当たり	ココロアタリ
ミラクル	ミラクル
処置	ショチ
マギー	マギー
向け	ムケ
失格	シッカク
複数	フクスウ
図書館	トショカン
尊重	ソンチョウ
キモ	キモ
レシピ	レシピ
亡くす	ナクス
クイズ	クイズ
ご用	ゴヨウ
ダイヤ	ダイヤ
曲がる	マガル
芽	メ
響く	ヒビク
サラダ	サラダ
でさえ	デサエ
よみがえる	ヨミガエル
直後	チョクゴ
プレイ	プレイ
坊や	ボウヤ
殺し屋	コロシヤ
はく	ハク
祭り	マツリ
エッチ	エッチ
ふむ	フム
上昇	ジョウショウ
本名	ホンミョウ
同行	ドウコウ
糸	イト
純	ジュン
見覚え	ミオボエ
服部	ハットリ
浦	ウラ
番目	バンメ
トロ	トロ
菊丸	キクマル
７月	７ガツ
っつう	ッツウ
てつ	テツ
テロリスト	テロリスト
撮れる	トレル
配置	ハイチ
どよめき	ドヨメキ
拡大	カクダイ
梨	ナシ
マヤ	マヤ
叔父さん	オジサン
キラキラ	キラキラ
末	マツ
蛇	ヘビ
さっぱり	サッパリ
尾行	ビコウ
年上	トシウエ
殺人犯	サツジンハン
あり	アリ
当たり	アタリ
キャシー	キャシー
出来	デキ
天下	テンカ
ヒット	ヒット
ピン	ピン
車両	シャリョウ
おかえりなさい	オカエリナサイ
蛭子	エビス
口座	コウザ
圭一	ケイイチ
教え	オシエ
アドバイス	アドバイス
がたい	ガタイ
イラ	イラ
ゆる	ユル
５月	５ガツ
夏目	ナツメ
香港	ホンコン
具体的	グタイテキ
異なる	コトナル
ロケット	ロケット
罪悪感	ザイアクカン
３月	３ガツ
列	レツ
数時間	スウジカン
無事に	ブジニ
医	イ
診断	シンダン
分かれる	ワカレル
国内	コクナイ
キャリア	キャリア
たまえ	タマエ
トレーラー	トレーラー
家具	カグ
援護	エンゴ
監禁	カンキン
義父	ギフ
８月	８ガツ
ゲット	ゲット
設計	セッケイ
ぞう	ゾウ
中絶	チュウゼツ
武装	ブソウ
照明	ショウメイ
販売	ハンバイ
合	ゴウ
段	ダン
とどめる	トドメル
低下	テイカ
大河	タイガ
苦痛	クツウ
仙	セン
救い	スクイ
つかめる	ツカメル
青年	セイネン
豪華	ゴウカ
ギリギリ	ギリギリ
作動	サドウ
発砲	ハッポウ
共有	キョウユウ
栄一郎	エイイチロウ
ダンサー	ダンサー
なつ	ナツ
噛む	カム
いい気	イイキ
しよう	シヨウ
ほんま	ホンマ
休める	ヤスメル
宝石	ホウセキ
殺生	セッショウ
カラス	カラス
海軍	カイグン
大成功	ダイセイコウ
収まる	オサマル
模様	モヨウ
静	セイ
長門	ナガト
昼間	ヒルマ
不利	フリ
夏美	ナツミ
サンド	サンド
追放	ツイホウ
くだる	クダル
こもる	コモル
のど	ノド
オレンジ	オレンジ
ダーク	ダーク
何かしら	ナニカシラ
姿勢	シセイ
タイガー	タイガー
あだ名	アダメイ
時に	トキニ
歌詞	カシ
上る	ノボル
出動	シュツドウ
取り出す	トリダス
整える	トトノエル
佐々木	ササキ
増す	マス
達成	タッセイ
パスタ	パスタ
当て	アテ
ロビー	ロビー
地位	チイ
着せる	キセル
絡む	カラム
穏やか	オダヤカ
金額	キンガク
がんばる	ガンバル
完ぺき	カンペキ
楽勝	ラクショウ
ヤギ	ヤギ
昇進	ショウシン
チャレンジ	チャレンジ
誤る	アヤマル
みつ	ミツ
レス	レス
無礼	ブレイ
目的地	モクテキチ
ディア	ディア
小便	ショウベン
乱暴	ランボウ
お客	オキャク
死人	シニン
素子	モトコ
通用	ツウヨウ
銭形	ゼニガタ
危	キ
誘惑	ユウワク
部品	ブヒン
払える	ハラエル
院長	インチョウ
ドーナツ	ドーナツ
居る	イル
便	ビン
田所	タドコロ
直	チョク
越前	エチゼン
革命	カクメイ
緊急事態	キンキュウジタイ
魔導士	マドウシ
アクション	アクション
承認	ショウニン
湧く	ワク
いじる	イジル
汽笛	キテキ
矢吹	ヤブキ
まもなく	マモナク
返る	カエル
メイ	メイ
頭痛	ズツウ
いやぁ	イヤァ
ネ	ネ
得点	トクテン
靴下	クツシタ
ベース	ベース
れん	レン
同じく	オナジク
いぬ	イヌ
ご苦労さま	ゴクロウサマ
電波	デンパ
食欲	ショクヨク
役立つ	ヤクタツ
からい	カライ
ゲート	ゲート
がっかり	ガッカリ
トール	トール
不安定	フアンテイ
後藤	ゴトウ
男らしい	オトコラシイ
醜い	ミニクイ
地点	チテン
こっそり	コッソリ
そっと	ソット
ベリー	ベリー
葬儀	ソウギ
おのれ	オノレ
ぜん	ゼン
オリバー	オリバー
何者か	ナニモノカ
向う	ムウ
少尉	ショウイ
かけ	カケ
聖書	セイショ
おん	オン
さてと	サテト
にて	ニテ
マス	マス
たた	タタ
信念	シンネン
大抵	タイテイ
走れる	ハシレル
主人公	シュジンコウ
使	シ
切断	セツダン
持ってこい	モッテコイ
礼儀	レイギ
サンキュー	サンキュー
バル	バル
変人	ヘンジン
ウッド	ウッド
塗装	トソウ
着陸	チャクリク
みのり	ミノリ
陰	イン
同	ドウ
パニック	パニック
ダル	ダル
てい	テイ
劇場	ゲキジョウ
毎週	マイシュウ
高木	タカギ
暗闇	クラヤミ
エルフ	エルフ
漫画	マンガ
スキャン	スキャン
自分自身	ジブンジシン
スピーチ	スピーチ
まる	マル
検証	ケンショウ
欲	ヨク
ペア	ペア
詐欺	サギ
エンタープライズ	エンタープライズ
ベトナム	ベトナム
託す	タクス
ナシ	ナシ
ミサイル	ミサイル
速	ソク
もっとも	モットモ
貧しい	マズシイ
任す	マカス
入学	ニュウガク
烏	カラス
考え方	カンガエカタ
分かり	ワカリ
分間	フンカン
少しずつ	スコシズツ
操縦	ソウジュウ
村長	ソンチョウ
小林	コバヤシ
心の中	ココロノナカ
負傷	フショウ
ブリ	ブリ
あかん	アカン
コメント	コメント
コンサート	コンサート
出席	シュッセキ
通過	ツウカ
布	ヌノ
細かい	コマカイ
ちくしょう	チクショウ
着	チャク
カルロス	カルロス
いっそ	イッソ
流川	リュウカワ
貸せる	カセル
契約書	ケイヤクショ
大谷	オオタニ
好物	コウブツ
惨め	サンメ
以降	イコウ
漢	カン
空腹	クウフク
仕上げる	シアゲル
守	シュ
溺れる	オボレル
知り合う	シリアウ
時には	トキニハ
伴う	トモナウ
宇宙船	ウチュウセン
指導者	シドウシャ
ほんとう	ホントウ
マイナス	マイナス
あれから	アレカラ
採用	サイヨウ
モニター	モニター
公平	コウヘイ
装備	ソウビ
おまけ	オマケ
冷める	サメル
ユキ	ユキ
同盟	ドウメイ
熱心	ネッシン
レコード	レコード
わく	ワク
付近	フキン
咲く	サク
池	イケ
漏らす	モラス
現状	ゲンジョウ
痕跡	コンセキ
サボる	サボル
呂	ロ
のむ	ノム
ハワイ	ハワイ
旗	ハタ
競技	キョウギ
蒼	アオ
負け犬	マケイヌ
生涯	ショウガイ
テイラー	テイラー
ぶっ殺す	ブッコロス
実況	ジッキョウ
菜穂	ナオ
一般	イッパン
月曜	ゲツヨウ
たかが	タカガ
ボロボロ	ボロボロ
両手	リョウテ
精神的	セイシンテキ
ところを	トコロヲ
夢見る	ユメミル
信者	シンジャ
カノン	カノン
愛し合う	イトシアウ
届け	トドケ
暗号	アンゴウ
自白	ジハク
シノ	シノ
でん	デン
乗り込む	ノリコム
仕返し	シカエシ
羅	ラ
ハワード	ハワード
古	コ
拓	タク
おやすみなさい	オヤスミナサイ
つながり	ツナガリ
今更	イマサラ
呪う	ノロウ
コウ	コウ
ざんする	ザンスル
判決	ハンケツ
小鷹	ショウタカ
生き方	イキカタ
直る	ナオル
明かす	アカス
率いる	ヒキイル
皆殺し	ミナコロシ
持ち込む	モチコム
検索	ケンサク
ケビン	ケビン
これら	コレラ
地井	チイ
結末	ケツマツ
軍曹	グンソウ
ミラー	ミラー
明かり	アカリ
ご機嫌	ゴキゲン
丘	オカ
地方	チホウ
悲惨	ヒサン
バイ	バイ
狂う	クルウ
サンドイッチ	サンドイッチ
手柄	テガラ
溶ける	トケル
貢献	コウケン
ジョセフ	ジョセフ
暴く	アバク
抗議	コウギ
本音	ホンネ
チリ	チリ
放置	ホウチ
とやら	トヤラ
キャサリン	キャサリン
司	ツカサ
いったん	イッタン
せいぜい	セイゼイ
とら	トラ
ブツ	ブツ
菊	キク
連行	レンコウ
お陰	オイン
チーフ	チーフ
巡査	ジュンサ
正面	ショウメン
トリ	トリ
幸平	コウヘイ
発揮	ハッキ
力む	リキム
誠実	セイジツ
くっつく	クッツク
悟る	サトル
才人	サイジン
手錠	テジョウ
報復	ホウフク
慈悲	ジヒ
被告人	ヒコクニン
じまう	ジマウ
取り返す	トリカエス
自己紹介	ジコショウカイ
それなのに	ソレナノニ
引っかかる	ヒッカカル
浮く	ウク
盾	タテ
看板	カンバン
転校生	テンコウセイ
フロリダ	フロリダ
モード	モード
上等	ジョウトウ
お返し	オカエシ
じいちゃん	ジイチャン
剣持	ケンジ
ぞい	ゾイ
リーグ	リーグ
クス	クス
テイル	テイル
勤務	キンム
減らす	ヘラス
繰り返し	クリカエシ
まう	マウ
自覚	ジカク
死神	シニガミ
ハマる	ハマル
受け止める	ウケヤメル
移植	イショク
空ける	アケル
魔術師	マジュツシ
リプレイ	リプレイ
暮らせる	クラセル
コラ	コラ
現代	ゲンダイ
おける	オケル
かたい	カタイ
バーガー	バーガー
景	ケイ
死にかける	シニカケル
シロ	シロ
保管	ホカン
気絶	キゼツ
温める	アタタメル
あちら	アチラ
ほな	ホナ
戻せる	モドセル
遺伝子	イデンシ
お休み	オヤスミ
上出来	ジョウデキ
不在	フザイ
足元	アシモト
基づく	モトヅク
幸	サチ
美しさ	ウツクシサ
しも	シモ
たまらない	タマラナイ
柚子	ユズ
セーラ	セーラ
付き合い	ツキアイ
気楽	キラク
濃い	コイ
かす	カス
修正	シュウセイ
抜け出す	ヌケダス
梨花	ナシハナ
座れる	スワレル
最	サイ
どうし	ドウシ
公表	コウヒョウ
恵まれる	メグマレル
跳ぶ	トブ
コナン	コナン
テリー	テリー
峰	ミネ
照	ショウ
生み出す	ウミダス
外国	ガイコク
火星	カセイ
視聴者	シチョウシャ
区	ク
同志	ドウシ
夏休み	ナツヤスミ
好む	コノム
暦	コヨミ
暴走	ボウソウ
最新	サイシン
滅ぼす	ホロボス
クジラ	クジラ
さす	サス
圧力	アツリョク
狸	タヌキ
負担	フタン
タイトル	タイトル
マフィア	マフィア
一流	イチリュウ
片付ける	カタヅケル
テント	テント
死後	シゴ
発作	ホッサ
逃走	トウソウ
カニ	カニ
怒鳴る	ドナル
慎	シン
見学	ケンガク
ジェット	ジェット
ストーン	ストーン
ポルノ	ポルノ
または	マタハ
ミッション	ミッション
却下	キャッカ
陥る	オチイル
兄上	アニウエ
版	ハン
リズム	リズム
今こそ	イマコソ
握手	アクシュ
丸い	マルイ
弥彦	ヤヒコ
軒	ケン
破れる	ヤブレル
緒	オ
代目	ダイメ
５つ	５ツ
削除	サクジョ
同級生	ドウキュウセイ
容赦	ヨウシャ
所長	ショチョウ
ハニー	ハニー
不気味	ブキミ
肝心	カンジン
ライダー	ライダー
対抗	タイコウ
逆転	ギャクテン
判明	ハンメイ
干渉	カンショウ
総理	ソウリ
こないだ	コナイダ
手助け	テダスケ
計	ケイ
バット	バット
出張	シュッチョウ
知恵	チエ
理事長	リジチョウ
しゅん	シュン
共同	キョウドウ
収める	オサメル
季節	キセツ
アクセス	アクセス
台所	ダイドコロ
固定	コテイ
検察	ケンサツ
ねずみ	ネズミ
まち	マチ
就く	ツク
救助	キュウジョ
現地	ゲンチ
バルカン	バルカン
凶器	キョウキ
素材	ソザイ
１月	１ガツ
いちいち	イチイチ
づく	ヅク
頑固	ガンコ
ビーム	ビーム
今では	イマデハ
権限	ケンゲン
黄色	キイロ
アレルギー	アレルギー
持ち上げる	モチアゲル
ええい	エエイ
サイド	サイド
ムショ	ムショ
傑作	ケッサク
貴	タカシ
ケイン	ケイン
みどり	ミドリ
使い方	ツカイカタ
お土産	オミヤゲ
ハリウッド	ハリウッド
一郎	イチロウ
ナンシー	ナンシー
歩む	アユム
熊	クマ
幻覚	ゲンカク
シャンパン	シャンパン
足る	タル
ってか	ッテカ
回戦	カイセン
質	シツ
お湯	オユ
忠誠	チュウセイ
義理	ギリ
近寄る	チカヨル
キン	キン
善人	ゼンニン
くるむ	クルム
シャン	シャン
でっかい	デッカイ
を通して	ヲトウシテ
波紋	ハモン
無効	ムコウ
物事	モノゴト
引っ越し	ヒッコシ
脚本	キャクホン
訪問	ホウモン
デレク	デレク
並べる	ナラベル
悪人	アクニン
着替え	キガエ
編集長	ヘンシュウチョウ
生まれ変わる	ウマレカワル
進展	シンテン
鐘の音	カネノオト
果物	クダモノ
植える	ウエル
いし	イシ
ごろ	ゴロ
あの世	アノヨ
お弁当	オベントウ
人前	ヒトマエ
ノート	ノート
水着	ミズギ
捕る	トル
配達	ハイタツ
場面	バメン
我が家	ワガヤ
栄光	エイコウ
誓い	チカイ
槍	ヤリ
消せる	ケセル
ダウン	ダウン
まどか	マドカ
とんだ	トンダ
絞る	シボル
えり	エリ
憎しみ	ニクシミ
天井	テンジョウ
穂	ホ
ペンギン	ペンギン
洞	ホラ
見張り	ミハリ
じっくり	ジックリ
初耳	ハツミミ
立ち向かう	タチムカウ
警部補	ケイブホ
髪の毛	カミノケ
カジノ	カジノ
ランディ	ランディ
何度か	ナンドカ
手作り	テヅクリ
皇后	コウゴウ
知事	チジ
カメ	カメ
役者	ヤクシャ
美和子	ミワコ
久々	ヒサビサ
体内	タイナイ
魁	カイ
クレイ	クレイ
今晩	コンバン
保	ホ
宇宙人	ウチュウジン
得	エ
眺める	ナガメル
議会	ギカイ
その辺	ソノヘン
陸軍	リクグン
ことば	コトバ
しら	シラ
地震	ジシン
リャン	リャン
個性	コセイ
由希	ユキ
カス	カス
強制	キョウセイ
科	カ
塊	カイ
徹底的	テッテイテキ
細い	コマイ
ステーキ	ステーキ
決意	ケツイ
ホール	ホール
ポテト	ポテト
あくび	アクビ
外科	ゲカ
失礼しました	シツレイシマシタ
おっぱい	オッパイ
ダイエット	ダイエット
入ろう	イロウ
外科医	ゲカイ
範囲	ハンイ
不能	フノウ
劇	ゲキ
浜	ハマ
討つ	ウツ
踊り	オドリ
オタク	オタク
ゴードン	ゴードン
層	ソウ
文	ブン
杏奈	アンナ
さも	サモ
メチャクチャ	メチャクチャ
長老	チョウロウ
いてる	イテル
揚げる	アゲル
理子	サトコ
巡る	メグル
昼食	チュウショク
束	ソク
温泉	オンセン
話し合い	ハナシアイ
養子	ヨウシ
ヒル	ヒル
具	グ
司会者	シカイシャ
探せる	サガセル
紳士	シンシ
最期	サイゴ
画像	ガゾウ
推測	スイソク
胃	イ
とうとう	トウトウ
ブレイク	ブレイク
粉	コナ
素早い	スバヤイ
ドク	ドク
占い	ウラナイ
陸	リク
フィン	フィン
ヨガ	ヨガ
髪形	カミガタ
どころ	ドコロ
便利	ベンリ
損	ソン
コンテスト	コンテスト
取り上げる	トリアゲル
委員長	イインチョウ
シスター	シスター
タマネギ	タマネギ
ヒナ	ヒナ
代償	ダイショウ
延期	エンキ
死因	シイン
かなあ	カナア
スト	スト
パティ	パティ
澤	サワ
ぎょ	ギョ
ソーセージ	ソーセージ
当日	トウジツ
ベッキー	ベッキー
いい話	イイハナシ
バイブ	バイブ
不正解	フセイカイ
仕切る	シキル
帰還	キカン
決心	ケッシン
逃亡	トウボウ
同居	ドウキョ
専用	センヨウ
いかに	イカニ
憎い	ニクイ
てく	テク
作業員	サギョウイン
刑	ケイ
刺さる	ササル
叔父	オジ
笛	フエ
フラッシュ	フラッシュ
冷やす	ヒヤス
椅子	イス
やばい	ヤバイ
党	トウ
小沢	オザワ
クロス	クロス
数学	スウガク
２月	２ガツ
ストライク	ストライク
忠実	チュウジツ
発進	ハッシン
足跡	ソクセキ
釣る	ツル
ごっこ	ゴッコ
サンプル	サンプル
整う	トトノウ
美樹	ミキ
重力	ジュウリョク
その上	ソノウエ
ちっとも	チットモ
不倫	フリン
乗員	ジョウイン
集会	シュウカイ
フェアリー	フェアリー
令状	レイジョウ
朝鮮	チョウセン
ジェームス	ジェームス
愛人	アイジン
追い込む	オイコム
カメラマン	カメラマン
コンビ	コンビ
タンク	タンク
ブラッド	ブラッド
ロサンゼルス	ロサンゼルス
ワニ	ワニ
最終的	サイシュウテキ
王室	オウシツ
集まり	アツマリ
ビースト	ビースト
ユリ	ユリ
多少	タショウ
ホット	ホット
要望	ヨウボウ
まれ	マレ
悪者	ワルモノ
貴族	キゾク
支払う	シハラウ
見てくれ	ミテクレ
オモチャ	オモチャ
マッチ	マッチ
山ほど	ヤマホド
羨ましい	ウラヤマシイ
話し声	ハナシゴエ
電子音	デンシオン
ガード	ガード
セレブ	セレブ
プリンセス	プリンセス
中佐	チュウサ
仕事中	シゴトチュウ
借り	カリ
発展	ハッテン
相性	アイショウ
紅茶	コウチャ
タフ	タフ
一日中	イチニチジュウ
一言	ヒトコト
味見	アジミ
ごわする	ゴワスル
事前	ジゼン
外国人	ガイコクジン
観る	ミル
はしゃぐ	ハシャグ
構造	コウゾウ
片方	カタホウ
次郎	ジロウ
沢	サワ
舞	マイ
スバル	スバル
もんで	モンデ
下ろせる	クダロセル
誘導	ユウドウ
魔物	マモノ
ストリート	ストリート
京	キョウ
皮膚	ヒフ
アリア	アリア
お姫様	オヒメサマ
ダブル	ダブル
サポート	サポート
てか	テカ
性的	セイテキ
根性	コンジョウ
端	ハジ
かわり	カワリ
くら	クラ
候補者	コウホシャ
巴	トモエ
演出	エンシュツ
眼鏡	メガネ
誰だって	ダレダッテ
Ｔシャツ	Ｔシャツ
はかせ	ハカセ
コーラ	コーラ
ニンニク	ニンニク
みなさん	ミナサン
山下	ヤマシタ
思考	シコウ
コメディアン	コメディアン
しる	シル
前向き	マエムキ
振動	シンドウ
渡	ワタリ
ハズレ	ハズレ
流行	リュウコウ
部門	ブモン
鎖	クサリ
キャー	キャー
ゴルフ	ゴルフ
スーザン	スーザン
せん	セン
働ける	ハタラケル
安藤	アンドウ
援助	エンジョ
ソフィア	ソフィア
なあに	ナアニ
調べ	シラベ
あーあ	アーア
ひつ	ヒツ
もしや	モシヤ
向き	ムキ
イザ	イザ
宮本	ミヤモト
最適	サイテキ
有効	ユウコウ
おばあさん	オバアサン
パタリ	パタリ
レモン	レモン
受け継ぐ	ウケツグ
キャスター	キャスター
げき	ゲキ
娼婦	ショウフ
平等	ビョウドウ
高度	コウド
とり	トリ
ほんで	ホンデ
ちがう	チガウ
ラッセル	ラッセル
所属	ショゾク
春田	ハルダ
昼寝	ヒルネ
順番	ジュンバン
ぬる	ヌル
快適	カイテキ
つまんない	ツマンナイ
出会える	デアエル
吸収	キュウシュウ
天津飯	テンシンハン
滅びる	ホロビル
達人	タツジン
ジャーナリスト	ジャーナリスト
喉	ノド
小学生	ショウガクセイ
くろい	クロイ
名人	メイジン
虐待	ギャクタイ
降ろす	フロス
切れ	キレ
博物館	ハクブツカン
尾	オ
目当て	メアテ
腫瘍	シュヨウ
茶	チャ
飲み込む	ノミコム
夕飯	ユウハン
尽きる	コトゴトキル
富	トミ
微妙	ビミョウ
魅	ミ
つぶす	ツブス
就職	シュウショク
澪	ミオ
デビュー	デビュー
みかん	ミカン
ローン	ローン
入	ニュウ
御堂筋	ミドウスジ
顧問	コモン
弁当	ベントウ
虹	ニジ
そういや	ソウイヤ
平凡	ヘイボン
アイ	アイ
ダーリン	ダーリン
領域	リョウイキ
かがむ	カガム
ぬれる	ヌレル
参加者	サンカシャ
申請	シンセイ
フォン	フォン
ますます	マスマス
ものの	モノノ
坂	サカ
隠し事	カクシゴト
域	イキ
派遣	ハケン
点滴	テンテキ
顔色	カオイロ
に対し	ニタイシ
挑戦者	チョウセンシャ
服装	フクソウ
校	コウ
アクア	アクア
さぁ	サァ
務め	ツトメ
才	サイ
智子	トモコ
飢える	ウエル
服役	フクエキ
お昼	オヒル
さまざま	サマザマ
すける	スケル
中国語	チュウゴクゴ
結界	ケッカイ
クリスタル	クリスタル
セラピー	セラピー
井	イ
内装	ナイソウ
製品	セイヒン
ざま	ザマ
ジュリエット	ジュリエット
ですから	デスカラ
手当て	テアテ
走行	ソウコウ
とぼける	トボケル
可	カ
旦那様	ダンナサマ
頼れる	タヨレル
魔法使い	マホウツカイ
つかさ	ツカサ
史上	シジョウ
成	セイ
日常	ニチジョウ
編集	ヘンシュウ
視線	シセン
閣下	カッカ
一平	イッペイ
慰める	ナグサメル
頭から	アタマカラ
チョウ	チョウ
レッスン	レッスン
値	アタイ
剛	ツヨシ
敗北	ハイボク
瓶	カメ
萌	ホウ
送れる	オクレル
コロンビア	コロンビア
接続	セツゾク
温度	オンド
こん	コン
しくじる	シクジル
桜井	サクライ
ウテナ	ウテナ
カバー	カバー
ダメージ	ダメージ
返済	ヘンサイ
隔離	カクリ
人気者	ニンキモノ
所有	ショユウ
栄養	エイヨウ
繊細	センサイ
製造	セイゾウ
貝	カイ
ありえる	アリエル
おくれる	オクレル
削る	ケズル
左右	サユウ
指名	シメイ
アルベルト	アルベルト
ポップ	ポップ
解決策	カイケツサク
非	ヒ
退学	タイガク
隻	セキ
アーサー	アーサー
うっする	ウッスル
厚い	アツイ
迷子	マイゴ
カーテン	カーテン
つまる	ツマル
召喚	ショウカン
常識	ジョウシキ
種族	シュゾク
絶対に	ゼッタイニ
ペース	ペース
分の１	ブンノイチ
椿	ツバキ
知人	チジン
交わす	マジワス
改装	カイソウ
海兵	カイヘイ
過ごせる	スゴセル
イスラエル	イスラエル
ティー	ティー
右手	ミギテ
士官	シカン
誇る	ホコル
お嬢	オジョウ
幼稚園	ヨウチエン
打ち明ける	ウチアケル
炒める	イタメル
聡	サトシ
ガッカリ	ガッカリ
上品	ジョウヒン
団体	ダンタイ
プラス	プラス
善	ゼン
家出	イエデ
小切手	コギッテ
本部長	ホンブチョウ
福田	フクダ
見え	ミエ
身元	ミモト
お話し	オハナシ
ニセ	ニセ
のり	ノリ
実感	ジッカン
白状	ハクジョウ
風船	フウセン
クモ	クモ
ひざまずく	ヒザマズク
ミー	ミー
未知	ミチ
裏切り	ウラギリ
降参	コウサン
ひざ	ヒザ
まんま	マンマ
楓	モミジ
滞在	タイザイ
無力	ムリョク
現象	ゲンショウ
理論	リロン
いつの間に	イツノマニ
スマホ	スマホ
セブン	セブン
いね	イネ
予選	ヨセン
外傷	ガイショウ
指図	サシズ
美遊	ビユウ
あれだけ	アレダケ
後半	コウハン
消滅	ショウメツ
金髪	キンパツ
風味	フウミ
エイ	エイ
お前さん	オマエサン
ボード	ボード
加工	カコウ
物質	ブッシツ
一撃	イチゲキ
誌	シ
いえいえ	イエイエ
ノーマン	ノーマン
クラ	クラ
不公平	フコウヘイ
砲	ホウ
ジャー	ジャー
丁寧	テイネイ
罪人	ザイニン
連合	レンゴウ
アピール	アピール
アプリ	アプリ
グラン	グラン
つぎ	ツギ
テッド	テッド
出世	シュッセ
加速	カソク
無敵	ムテキ
ゴリラ	ゴリラ
トッド	トッド
美月	ミツキ
潰れる	ツブレル
降伏	コウフク
水中	スイチュウ
麻子	アサコ
チャド	チャド
なるべく	ナルベク
機体	キタイ
遺産	イサン
マルコ	マルコ
ルーカス	ルーカス
宝物	タカラモノ
持ち出す	モチダス
萬田	マンタ
ずるい	ズルイ
トレーニング	トレーニング
ばか	バカ
ほた	ホタ
下る	クダル
圭	ケイ
寸前	スンゼン
忘れ物	ワスレモノ
貧乏	ビンボウ
進歩	シンポ
みゆき	ミユキ
リッチ	リッチ
新入り	シンイリ
酔っ払う	ヨッハラウ
いよ	イヨ
えーと	エート
キヨシ	キヨシ
フック	フック
弓	ユミ
伊藤	イトウ
さやか	サヤカ
俺様	オレサマ
外せる	ハズセル
進行	シンコウ
雫	シズク
ふくしゅう	フクシュウ
棟	トウ
移民	イミン
連れ戻す	ツレモドス
ともだち	トモダチ
ピンチ	ピンチ
構える	カマエル
空っぽ	カラッポ
本能	ホンノウ
いか	イカ
スキー	スキー
バスターズ	バスターズ
初春	ショシュン
弱る	ヨワル
海岸	カイガン
県	ケン
いたずら	イタズラ
フィル	フィル
モーテル	モーテル
弁護	ベンゴ
直ちに	タダチニ
直樹	ナオキ
八木	ヤギ
欲望	ヨクボウ
無理やり	ムリヤリ
別荘	ベッソウ
名字	ミョウジ
飾り	カザリ
スティーブン	スティーブン
サーブ	サーブ
デル	デル
ホレる	ホレル
原稿	ゲンコウ
演説	エンゼツ
ジョンソン	ジョンソン
デビッド	デビッド
朱	シュ
基準	キジュン
キャット	キャット
そらす	ソラス
乗客	ジョウキャク
合宿	ガッシュク
魏	ギ
アカ	アカ
サミー	サミー
レディー	レディー
寮	リョウ
無罪	ムザイ
金城	キンジョウ
っぱなし	ッパナシ
引き取る	ヒキトル
練る	ネル
置ける	オケル
連れ出す	ツレダス
おかけ	オカケ
方々	カタガタ
死にそう	シニソウ
ジャングル	ジャングル
受刑者	ジュケイシャ
缶	カン
ココロ	ココロ
スパイク	スパイク
対戦	タイセン
父ちゃん	トウチャン
経過	ケイカ
シェリル	シェリル
みち子	ミチコ
奉る	マツル
振り回す	フリマワス
ギア	ギア
黒幕	クロマク
ロット	ロット
明確	メイカク
調理	チョウリ
ライター	ライター
トリック	トリック
パッ	パッ
マック	マック
冷える	ヒエル
至急	シキュウ
有能	ユウノウ
調達	チョウタツ
出	シュツ
夕方	ユウガタ
麗子	レイコ
こえる	コエル
ターゲット	ターゲット
デタラメ	デタラメ
収録	シュウロク
甥	オイ
ワイ	ワイ
人魚	ニンギョ
時速	ジソク
隣人	リンジン
ネジ	ネジ
手袋	テブクロ
枕	マクラ
もしくは	モシクハ
画面	ガメン
考え直す	カンガエナオス
追い払う	オイハラウ
コツ	コツ
ブライト	ブライト
眠り	ネムリ
精霊	セイレイ
リンダ	リンダ
子守	コモリ
神殿	シンデン
ちゃーん	チャーン
デッキ	デッキ
警察署	ケイサツショ
台本	ダイホン
持ち帰る	モチカエル
シート	シート
チューブ	チューブ
共	トモ
ガム	ガム
ステップ	ステップ
ストーカー	ストーカー
久住	クジュウ
人種	ジンシュ
回避	カイヒ
あえて	アエテ
例外	レイガイ
兼	ケン
好きなだけ	スキナダケ
房	ボウ
盛る	モル
裕	ヒロシ
アリバイ	アリバイ
地下室	チカシツ
比	ヒ
バード	バード
はめる	ハメル
川島	カワシマ
徐々に	ジョジョニ
警護	ケイゴ
ステ	ステ
一時的	イチジテキ
崩す	クズス
祝い	イワイ
晶	アキ
独特	ドクトク
アマ	アマ
いいところ	イイトコロ
かしこまる	カシコマル
どっちか	ドッチカ
ふふふ	フフフ
まき	マキ
中学生	チュウガクセイ
初対面	ショタイメン
取り引き	トリヒキ
測る	ハカル
お伝え	オツタエ
ヤツ	ヤツ
反乱	ハンラン
見返り	ミカエリ
のる	ノル
主義	シュギ
遥	ハルカ
部活	ブカツ
長原	ナガハラ
ケルベロス	ケルベロス
保存	ホゾン
怜	レイ
琥珀	コハク
癖	クセ
連絡先	レンラクサキ
大半	タイハン
ジーク	ジーク
参考	サンコウ
焼き	ヤキ
持ち	モチ
語	ゴ
チョコレート	チョコレート
値する	アタイスル
晴子	ハルコ
負える	オエル
雛	ヒナ
しだい	シダイ
タイラー	タイラー
泡	アワ
驚かす	オドロカス
夜明け	ヨアケ
小鳥	コトリ
シマ	シマ
ヘタ	ヘタ
ベルリン	ベルリン
免許	メンキョ
共通点	キョウツウテン
翔太	ショウタ
カツ	カツ
将	ショウ
幕	マク
エン	エン
ビッチ	ビッチ
妊婦	ニンプ
柱	ハシラ
チンピラ	チンピラ
捕虜	ホリョ
坊主	ボウズ
つまむ	ツマム
余る	アマル
出入り	デイリ
司令部	シレイブ
津田	ツダ
西田	ニシダ
キノコ	キノコ
ソ連	ソレン
杖	ツエ
ツリー	ツリー
テラスハウス	テラスハウス
上陸	ジョウリク
文明	ブンメイ
いれる	イレル
太一	タイチ
生徒会	セイトカイ
てっきり	テッキリ
合意	ゴウイ
放棄	ホウキ
極秘	ゴクヒ
貫く	ツラヌク
オペレーター	オペレーター
ゴシップ	ゴシップ
到達	トウタツ
監視カメラ	カンシカメラ
網	アミ
見れる	ミレル
覚え	オボエ
シャトル	シャトル
ピート	ピート
和解	ワカイ
当初	トウショ
手間	テマ
斎	サイ
かま	カマ
クラーク	クラーク
ニーナ	ニーナ
ペニー	ペニー
執事	シツジ
葉山	ハヤマ
衛星	エイセイ
にかけて	ニカケテ
パトカー	パトカー
夜空	ヨゾラ
息遣い	イキヅカイ
融合	ユウゴウ
ドロ	ドロ
要するに	ヨウスルニ
デニス	デニス
メーカー	メーカー
当局	トウキョク
騎	キ
かえり	カエリ
ハッキリ	ハッキリ
伯爵	ハクシャク
手嶋	テジマ
櫻子	サクラコ
てこ	テコ
コブ	コブ
当分	トウブン
斉木	サイキ
暖かい	アタタカイ
葬る	ホウムル
国際	コクサイ
徹夜	テツヤ
ブルック	ブルック
傘	カサ
あくまで	アクマデ
キムチ	キムチ
経済	ケイザイ
パリス	パリス
斎藤	サイトウ
沈黙	チンモク
禁じる	キンジル
転校	テンコウ
その代わり	ソノカワリ
やっかい	ヤッカイ
ワールド	ワールド
万歳	バンザイ
山本	ヤマモト
銃弾	ジュウダン
反	ハン
早乙女	サオトメ
無限	ムゲン
たけ	タケ
共感	キョウカン
単位	タンイ
子育て	コソダテ
巫女	ミコ
豊富	ホウフ
選	セン
間もなく	カンモナク
防衛	ボウエイ
早苗	サナエ
梨奈	ナシナ
お先に	オサキニ
ドライバー	ドライバー
ホセ	ホセ
ユーロ	ユーロ
人格	ジンカク
岡村	オカムラ
真琴	マコト
高まる	タカマル
お気の毒	オキノドク
加護	カゴ
現	ゲン
馬車	バシャ
シスコ	シスコ
願	ガン
ジェル	ジェル
ニュー	ニュー
はまる	ハマル
みち	ミチ
先頭	セントウ
威力	イリョク
戸惑う	トマドウ
行い	オコナイ
６つ	６ツ
いただき	イタダキ
一輝	イッキ
墜落	ツイラク
製作	セイサク
送信	ソウシン
乾く	カワク
強引	ゴウイン
新しく	アタラシク
クラクション	クラクション
古城	コジョウ
怪獣	カイジュウ
新作	シンサク
毎朝	マイアサ
観光	カンコウ
遭遇	ソウグウ
ジョナサン	ジョナサン
ばば	ババ
よって	ヨッテ
祖国	ソコク
見直す	ミナオス
グランド	グランド
もめる	モメル
もる	モル
余地	ヨチ
侵入者	シンニュウシャ
先祖	センゾ
柳	ヤナギ
許し	ユルシ
バーベキュー	バーベキュー
不快	フカイ
権	ケン
規制	キセイ
ハム	ハム
大阪	オオサカ
度胸	ドキョウ
陪審員	バイシンイン
ネギ	ネギ
よっぽど	ヨッポド
男の人	オトコノニン
見せつける	ミセツケル
隠れ家	カクレイエ
における	ニオケル
ベーコン	ベーコン
吹雪	フブキ
決勝戦	ケッショウセン
留守電	ルスデン
ラリー	ラリー
リンク	リンク
吹っ飛ぶ	フットブ
士道	サムライミチ
決闘	ケットウ
関	カン
ナス	ナス
仏	ホトケ
感激	カンゲキ
はじ	ハジ
京介	キョウスケ
引き出す	ヒキダス
キース	キース
コーン	コーン
ブス	ブス
生命体	セイメイタイ
装う	ヨソオウ
遼	リョウ
伝	デン
太田	オオタ
深夜	シンヤ
何よりも	ナニヨリモ
出勤	シュッキン
あたり	アタリ
トー	トー
内海	ウツミ
チセ	チセ
整備	セイビ
角度	カクド
いるか	イルカ
お宝	オタカラ
仕上げ	シアゲ
金属	キンゾク
ディス	ディス
マンション	マンション
寝かせる	ネカセル
手首	テクビ
押しつける	オシツケル
牧	マキ
身内	ミウチ
忍者	ニンジャ
案件	アンケン
いこう	イコウ
レディ	レディ
堀尾	ホリオ
いいとこ	イイトコ
元々	モトモト
通路	ツウロ
けが	ケガ
ホーム	ホーム
下品	ゲヒン
起こし	オコシ
フランツ	フランツ
医学	イガク
直感	チョッカン
規模	キボ
鎧	ヨロイ
スイーツ	スイーツ
人組	ニングミ
ぜいたく	ゼイタク
その方	ソノホウ
例える	タトエル
侍	サムライ
図	ズ
自業自得	ジゴウジトク
レナ	レナ
寄せる	ヨセル
検視	ケンシ
歌える	ウタエル
結	ケツ
聖杯	セイハイ
いわゆる	イワユル
ホー	ホー
置き去り	オキザリ
作り話	ツクリハナシ
念	ネン
脇	ワキ
裁判長	サイバンチョウ
開催	カイサイ
お気	オキ
ナイ	ナイ
板	イタ
ためらう	タメラウ
パスポート	パスポート
口論	コウロン
生存者	セイゾンシャ
須藤	スドウ
スキル	スキル
不二	フジ
古代	コダイ
潜る	モグル
ロブ	ロブ
左手	ヒダリテ
白鳥	ハクチョウ
引き継ぐ	ヒキツグ
がち	ガチ
グラム	グラム
デモ	デモ
ホームレス	ホームレス
固まる	カタマル
欠く	カク
リトル	リトル
お方	オホウ
がく	ガク
そろえる	ソロエル
タラ	タラ
ちょっとした	チョットシタ
新田	ニッタ
無謀	ムボウ
ァ	ァ
中国人	チュウゴクジン
と言っても	トイッッテモ
除く	ノゾク
智	サトル
狩	カリ
かなめ	カナメ
スポンジ	スポンジ
びん	ビン
受賞	ジュショウ
滝	タキ
高める	タカメル
コンビニ	コンビニ
マイアミ	マイアミ
一弥	カズヤ
受付	ウケツケ
果て	ハテ
芸人	ゲイニン
アラスカ	アラスカ
敷く	シク
業	ギョウ
ジャム	ジャム
わら	ワラ
捉える	トラエル
紀子	キコ
スピーカー	スピーカー
とかいう	トカイウ
口実	コウジツ
向かい	ムカイ
あつい	アツイ
かばん	カバン
ディレクター	ディレクター
バースデー	バースデー
意図	イト
特訓	トックン
クレイジー	クレイジー
シェリー	シェリー
働き	ハタラキ
戦場ヶ原	センジョウヶハラ
指摘	シテキ
西片	ニシカタ
麦わら	ムギワラ
承る	ウケタマワル
背く	ソムク
陰謀	インボウ
シェパード	シェパード
取り戻せる	トリモドセル
小夜	サヨ
茜	アカネ
辛抱	シンボウ
トス	トス
だんだん	ダンダン
なんてこった	ナンテコッタ
何様	ナニサマ
カート	カート
モノマネ	モノマネ
生じる	ショウジル
豆腐	トウフ
ヴィー	ヴィー
おし	オシ
ハッハッハ	ハッハッハ
仲よく	ナカヨク
沢山	タクサン
インタ	インタ
ケネディ	ケネディ
ワル	ワル
郷子	サトコ
隠せる	カクセル
コネ	コネ
予備	ヨビ
建築	ケンチク
救世主	キュウセイシュ
ヴァン	ヴァン
ハット	ハット
ツキ	ツキ
免れる	マヌカレル
着信	チャクシン
長谷	ハセ
駆けつける	カケツケル
駒	コマ
おいら	オイラ
コンピュータ	コンピュータ
団結	ダンケツ
げー	ゲー
ワイルド	ワイルド
射撃	シャゲキ
餃子	ギョウザ
キャリー	キャリー
じじい	ジジイ
ハンマー	ハンマー
救急	キュウキュウ
明智	アケチ
汁	シル
たどり着く	タドリツク
つえ	ツエ
いたる	イタル
合計	ゴウケイ
拉致	ラチ
方針	ホウシン
香水	コウスイ
かえる	カエル
ストレート	ストレート
バーン	バーン
片	ヘン
直せる	ナオセル
身分	ミブン
進んで	ススンデ
うっかり	ウッカリ
カモ	カモ
コリン	コリン
ダイアン	ダイアン
パンク	パンク
慶	ヨシ
月島	ガツシマ
芸術家	ゲイジュツカ
売り上げ	ウリアゲ
膝	ヒザ
抱きしめる	ダキシメル
潜む	ヒソム
たくらむ	タクラム
たんす	タンス
税金	ゼイキン
フェア	フェア
克服	コクフク
寿	ヒサシ
盗み	ヌスミ
荒れる	アレル
高価	コウカ
たどる	タドル
ベア	ベア
募集	ボシュウ
千代	チヨ
氷室	ヒムロ
沙都子	サトコ
現す	アラワス
録画	ロクガ
工事	コウジ
ジェス	ジェス
ソル	ソル
内側	ウチガワ
投与	トウヨ
達す	タッス
子犬	コイヌ
招待状	ショウタイジョウ
時刻	ジコク
女の人	オンナノヒト
由乃	ユノ
睡眠	スイミン
イマイチ	イマイチ
いまだに	イマダニ
エミ	エミ
でく	デク
落	ラク
率直	ソッチョク
脱走	ダッソウ
貸し	カシ
いとう	イトウ
おきる	オキル
オシャレ	オシャレ
コイン	コイン
ナチス	ナチス
めでたい	メデタイ
取り除く	トリノゾク
さがす	サガス
亜美	アミ
収容	シュウヨウ
幼なじみ	ヨウナジミ
放る	ホウル
零	レイ
大切な人	タイセツナニン
肝臓	カンゾウ
高速	コウソク
エージェント	エージェント
サニー	サニー
セミ	セミ
差し出す	サシダス
巻島	カンシマ
毛布	モウフ
こっから	コッカラ
のんびり	ノンビリ
売春婦	バイシュンフ
手伝える	テツダエル
誰にでも	ダレニデモ
マンガ	マンガ
凶暴	キョウボウ
ノン	ノン
包丁	ホウチョウ
料理人	リョウリニン
気合い	キアイ
総統	ソウトウ
傭兵	ヨウヘイ
神聖	シンセイ
くしゃみ	クシャミ
さんま	サンマ
正人	マサヒト
楽園	ラクエン
イングランド	イングランド
オール	オール
わがまま	ワガママ
容体	ヨウタイ
山口	ヤマグチ
推薦	スイセン
記念日	キネンビ
人口	ジンコウ
急用	キュウヨウ
意地	イジ
等	ナド
身体	シンタイ
遠藤	エンドウ
けつ	ケツ
スカート	スカート
せきこむ	セキコム
ミニ	ミニ
ムチ	ムチ
われ	ワレ
独自	ドクジ
キャンセル	キャンセル
嫌がらせ	イヤガラセ
役人	ヤクニン
アヒル	アヒル
ひで	ヒデ
運営	ウンエイ
唱える	トナエル
清水	シミズ
ガソリン	ガソリン
サツ	サツ
ショット	ショット
ヒカリ	ヒカリ
大学生	ダイガクセイ
布団	フトン
泰	ヤスシ
車内	シャナイ
野生	ヤセイ
オスカー	オスカー
状	ジョウ
たか	タカ
タワー	タワー
ちん	チン
へえー	ヘエー
冠	カン
打ち合わせ	ウチアワセ
類	ルイ
飛び降りる	トビオリル
チュン	チュン
ピエロ	ピエロ
ヒップホップ	ヒップホップ
その頃	ソノゴロ
偏見	ヘンケン
優勝者	ユウショウシャ
反対側	ハンタイガワ
特技	トクギ
口説く	クドク
アンドリュー	アンドリュー
写る	ウツル
カルテル	カルテル
ボトル	ボトル
小娘	コムスメ
我が国	ワガクニ
ジジイ	ジジイ
つなげる	ツナゲル
供述	キョウジュツ
制限	セイゲン
カリ	カリ
これぞ	コレゾ
ナオミ	ナオミ
みこ	ミコ
女将	ジョショウ
途端	トタン
あずさ	アズサ
かよ	カヨ
キリ	キリ
スズ	スズ
すすり泣き	ススリナキ
すべ	スベ
添える	ソエル
清	キヨシ
説	セツ
ボーン	ボーン
ほほ	ホホ
伊織	イオリ
寿命	ジュミョウ
頂点	チョウテン
フード	フード
浅い	アサイ
立ち入り禁止	タチイリキンシ
いつの間にか	イツノマニカ
スイス	スイス
何となく	ナントナク
作り出す	ツクリダス
政権	セイケン
落下	ラッカ
言い出す	イイダス
踊れる	オドレル
いくらでも	イクラデモ
トランク	トランク
ランプ	ランプ
レーザー	レーザー
点数	テンスウ
誘い	サソイ
趙	チョウ
通称	ツウショウ
セーフ	セーフ
秩序	チツジョ
クロウ	クロウ
しんのすけ	シンノスケ
スレイヤー	スレイヤー
自分勝手	ジブンカッテ
かな	カナ
キリスト	キリスト
一晩中	ヒトバンジュウ
弦	ゲン
勝ち目	カチメ
お仕置き	オシオキ
くむ	クム
バッジ	バッジ
ホスト	ホスト
ポン	ポン
放題	ホウダイ
がい	ガイ
リナ	リナ
価格	カカク
こなす	コナス
ブリー	ブリー
差し上げる	サシアゲル
イブ	イブ
ウイスキー	ウイスキー
シド	シド
ヒト	ヒト
ヘルメット	ヘルメット
やめ	ヤメ
乗っ取る	ノットル
井戸	イド
引き渡す	ヒキワタス
早めに	ハヤメニ
経営者	ケイエイシャ
ブログ	ブログ
みや	ミヤ
仕組み	シクミ
治	オサム
玄	ゲン
アルファ	アルファ
ジル	ジル
チャンネル	チャンネル
幸福	コウフク
挑発	チョウハツ
放課後	ホウカゴ
明朝	ミョウチョウ
片づけ	カタヅケ
発想	ハッソウ
どういたしまして	ドウイタシマシテ
ファニー	ファニー
思わず	オモワズ
撤回	テッカイ
きっちり	キッチリ
フランス語	フランスゴ
数々	カズカズ
楽器	ガッキ
やり遂げる	ヤリトゲル
暴動	ボウドウ
そうして	ソウシテ
はいる	ハイル
懸かる	カカル
染める	ソメル
誇らしい	ホコラシイ
都会	トカイ
ナタリー	ナタリー
ひめる	ヒメル
万が一	マンガイチ
打てる	ウテル
瑞希	ズイマレ
背後	ハイゴ
補給	ホキュウ
２番目	２バンメ
さんざん	サンザン
ブザー	ブザー
中断	チュウダン
崖	ガケ
手順	テジュン
欧州	オウシュウ
痛める	イタメル
ドーン	ドーン
わが	ワガ
共通	キョウツウ
商人	ショウニン
汚染	オセン
開	カイ
開店	カイテン
スプーン	スプーン
とがめる	トガメル
号線	ゴウセン
圧倒的	アットウテキ
日曜日	ニチヨウビ
賢明	ケンメイ
会員	カイイン
沼	ヌマ
龍彦	タツヒコ
アブ	アブ
失せろ	ウセロ
照らす	テラス
ニワトリ	ニワトリ
巻	カン
思いやり	オモイヤリ
思い込む	オモイコム
知世	トモヨ
試みる	ココロミル
講義	コウギ
グラント	グラント
ゆかり	ユカリ
嶋	シマ
通知	ツウチ
テンション	テンション
わーい	ワーイ
上田	ウエダ
化粧	ケショウ
戦力	センリョク
率	リツ
親指	オヤユビ
兄様	アニサマ
呼び出し音	ヨビダシオト
小宇宙	ショウウチュウ
砕く	クダク
酔っ払い	ヨッハライ
ご注文	ゴチュウモン
カウンター	カウンター
キュア	キュア
とともに	トトモニ
放火	ホウカ
発つ	タツ
サー	サー
大陸	タイリク
押して	オシテ
閉店	ヘイテン
おしゃれ	オシャレ
カナ	カナ
子分	コブン
感謝祭	カンシャサイ
殺人鬼	サツジンキ
絶好調	ゼッコウチョウ
コナー	コナー
ハッパ	ハッパ
ぶっ飛ばす	ブットバス
レーダー	レーダー
対立	タイリツ
手掛かり	テガカリ
抜群	バツグン
渡辺	ワタナベ
王宮	オウキュウ
読書	ドクショ
あゆみ	アユミ
インターハイ	インターハイ
それなり	ソレナリ
人材	ジンザイ
固める	カタメル
差す	サス
役員	ヤクイン
鑑識	カンシキ
青木	アオキ
オーバー	オーバー
ご褒美	ゴホウビ
スケジュール	スケジュール
渋滞	ジュウタイ
輝き	カガヤキ
コンセプト	コンセプト
ルカ	ルカ
治療法	チリョウホウ
ストーリー	ストーリー
なるみ	ナルミ
ニンジン	ニンジン
リボン	リボン
万全	バンゼン
上位	ジョウイ
力強い	チカラヅヨイ
欠点	ケッテン
聞かす	キカス
およそ	オヨソ
どす	ドス
ポスター	ポスター
主婦	シュフ
口出し	クチダシ
川谷	カワタニ
オイル	オイル
スカウト	スカウト
セントラル	セントラル
フェニックス	フェニックス
産業	サンギョウ
パーツ	パーツ
ひらめく	ヒラメク
まみれ	マミレ
地球人	チキュウジン
掟	オキテ
広まる	ヒロマル
考慮	コウリョ
膨らむ	フクラム
込み	コミ
郊外	コウガイ
あんだ	アンダ
ピッ	ピッ
ロード	ロード
白雪	シラユキ
チェーン	チェーン
乱れる	ミダレル
土曜日	ドヨウビ
委員	イイン
枠	ワク
要	ヨウ
議長	ギチョウ
過酷	カコク
あんま	アンマ
パイプ	パイプ
召し上がる	メシアガル
悪気	ワルギ
習慣	シュウカン
請求	セイキュウ
フライ	フライ
マスタング	マスタング
不動産	フドウサン
広場	ヒロバ
拝見	ハイケン
指定	シテイ
暁	アカツキ
痛い目	イタイメ
ぎん	ギン
リハーサル	リハーサル
捕獲	ホカク
歴史家	レキシカ
破片	ハヘン
経歴	ケイレキ
遊園地	ユウエンチ
餅	モチ
スグ	スグ
基本的	キホンテキ
ばつ	バツ
みれる	ミレル
入り込む	ハイリコム
小木	オギ
河村	カワムラ
積極的	セッキョクテキ
えーっと	エーット
なんぞ	ナンゾ
台湾	タイワン
子どもたち	コドモタチ
振る舞う	フルマウ
神谷	カミヤ
恥じる	ハジル
曲げる	マゲル
狐	キツネ
発音	ハツオン
遂行	スイコウ
一味	ヒトアジ
血管	ケッカン
いずみ	イズミ
タレ	タレ
おごり	オゴリ
ラッパー	ラッパー
仕打ち	シウチ
学べる	マナベル
座標	ザヒョウ
渇く	カワク
オン	オン
メリークリスマス	メリークリスマス
予言	ヨゲン
指令	シレイ
核	カク
苦情	クジョウ
あや	アヤ
ご一緒	ゴイッショ
ニス	ニス
勢力	セイリョク
執着	シュウチャク
エレナ	エレナ
さみしい	サミシイ
ホース	ホース
やり直し	ヤリナオシ
我が社	ワガシャ
暴露	バクロ
聖なる	ヒジリナル
過程	カテイ
サーカス	サーカス
シェーン	シェーン
たった１人	タッタ１ニン
ふたり	フタリ
プリン	プリン
うり	ウリ
おしり	オシリ
ミゲル	ミゲル
黄	キ
お祭り	オマツリ
並んで	ナランデ
北部	ホクブ
団長	ダンチョウ
暮れる	クレル
橘	タチバナ
重傷	ジュウショウ
バレエ	バレエ
定	テイ
提督	テイトク
カラオケ	カラオケ
たたえる	タタエル
フル	フル
大昔	オオムカシ
法的	ホウテキ
財団	ザイダン
屈辱	クツジョク
組み合わせ	クミアワセ
鳳	オオトリ
っしょ	ッショ
マダム	マダム
依存症	イゾンショウ
全米	ゼンベイ
キティ	キティ
多数	タスウ
あっという間に	アットイウマニ
拠点	キョテン
祭	マツリ
葵	アオイ
解読	カイドク
ボーグ	ボーグ
組合	クミアイ
転がる	コロガル
野明	ノメイ
エイリアン	エイリアン
ニール	ニール
ロク	ロク
丈	タケ
隠る	カクル
おおい	オオイ
だく	ダク
交流	コウリュウ
仕込む	シコム
寝息	ネイキ
自首	ジシュ
ご挨拶	ゴアイサツ
しめる	シメル
京都	キョウト
兵衛	ベエ
外部	ガイブ
節約	セツヤク
ネクタイ	ネクタイ
ミカ	ミカ
瀬戸	セト
花道	ハナミチ
裁く	サバク
風間	カザマ
ウマ	ウマ
ウン	ウン
偵察	テイサツ
堅い	カタイ
封じる	フウジル
老	ロウ
銀河	ギンガ
シェル	シェル
ドラム	ドラム
不愉快	フユカイ
使者	シシャ
律子	リツコ
村田	ムラタ
ダチ	ダチ
とどまる	トドマル
ルーム	ルーム
交信	コウシン
動物園	ドウブツエン
意味不明	イミフメイ
無茶	ムチャ
続行	ゾッコウ
老師	ロウシ
闘い	タタカイ
島田	シマダ
更新	コウシン
眺め	ナガメ
あの方	アノホウ
ボランティア	ボランティア
仮に	カリニ
単に	タンニ
実在	ジツザイ
引きずる	ヒキズル
持	ジ
功績	コウセキ
収入	シュウニュウ
手加減	テカゲン
うせる	ウセル
くじ	クジ
スポンサー	スポンサー
パジャマ	パジャマ
フェイス	フェイス
保安	ホアン
命中	メイチュウ
ウェイン	ウェイン
オイラ	オイラ
ゴミ箱	ゴミハコ
ひん	ヒン
一松	イチマツ
縫う	ヌウ
順位	ジュンイ
オフ	オフ
偽り	イツワリ
災い	ワザワイ
荷	カ
農家	ノウカ
黄色い	キイロイ
インターン	インターン
かわす	カワス
くに	クニ
ショップ	ショップ
一夜	イチヤ
仕掛け	シカケ
寧	ネイ
表面	ヒョウメン
ウェス	ウェス
お見通し	オミトオシ
ゲイリー	ゲイリー
ハロ	ハロ
ヘロイン	ヘロイン
冊	サツ
勲章	クンショウ
取り組む	トリクム
水泳	スイエイ
賢也	ケンヤ
難民	ナンミン
わな	ワナ
任	ニン
居心地	イゴコチ
打球	ダキュウ
海兵隊	カイヘイタイ
破裂	ハレツ
試食	シショク
いやー	イヤー
グッド	グッド
ハロウィーン	ハロウィーン
三船	ミフネ
女子高生	ジョシコウセイ
くつろぐ	クツログ
ランス	ランス
乳首	チクビ
引き裂く	ヒキサク
漂う	タダヨウ
稼ぎ	カセギ
スゲ	スゲ
それら	ソレラ
変装	ヘンソウ
室谷	ムロヤ
文書	ブンショ
病人	ビョウニン
食品	ショクヒン
内臓	ナイゾウ
史	シ
思いっきり	オモイッキリ
期限	キゲン
真犯人	シンハンニン
荷造り	ニヅクリ
みそ	ミソ
先住民	センジュウミン
泊める	トメル
陥れる	オチイレル
つかまえる	ツカマエル
やけに	ヤケニ
射殺	シャサツ
手ごわい	テゴワイ
いづ	イヅ
ミミ	ミミ
もち	モチ
教	キョウ
腎臓	ジンゾウ
適切	テキセツ
鹿	シカ
からには	カラニハ
ヶ月	ヶガツ
周年	シュウネン
命懸け	イノチカケ
大歓迎	ダイカンゲイ
理事	リジ
腹ペコ	ハラペコ
送り込む	オクリコム
連れ去る	ツレサル
いわば	イワバ
ティファニー	ティファニー
デス	デス
大人気	ダイニンキ
引け	ヒケ
悪霊	アクリョウ
織姫	ショクヒメ
自力	ジリキ
アニキ	アニキ
サリー	サリー
シオン	シオン
ロッカー	ロッカー
研修	ケンシュウ
青峰	アオミネ
願い事	ネガイゴト
あいにく	アイニク
グル	グル
仲良し	ナカヨシ
芝	シバ
解消	カイショウ
関東	カントウ
保護者	ホゴシャ
冒険者	ボウケンシャ
塞ぐ	フサグ
寛大	カンダイ
探知	タンチ
準決勝	ジュンケッショウ
解体	カイタイ
あそぶ	アソブ
コック	コック
ふじ	フジ
独りぼっち	ヒトリボッチ
公生	コウナマ
包囲	ホウイ
描ける	エガケル
童貞	ドウテイ
臆病者	オクビョウモノ
タコス	タコス
歴	レキ
論文	ロンブン
真波	マコトナミ
若	ジャク
見つけ出す	ミツケダス
ハエ	ハエ
動	ドウ
気がつく	キガツク
決戦	ケッセン
ひかり	ヒカリ
プレーヤー	プレーヤー
会合	カイゴウ
名声	メイセイ
残れる	ノコレル
移住	イジュウ
ことし	コトシ
ヒデ	ヒデ
手足	テアシ
濡れる	ヌレル
アクセル	アクセル
スパーク	スパーク
ドラ	ドラ
裕福	ユウフク
あらす	アラス
ソク	ソク
不十分	フジュウブン
巡査部長	ジュンサブチョウ
心臓発作	シンゾウホッサ
態勢	タイセイ
絶滅	ゼツメツ
軍団	グンダン
オーブン	オーブン
カズ	カズ
ブルックリン	ブルックリン
上空	ジョウクウ
移送	イソウ
程	ホド
精神科	セイシンカ
でないと	デナイト
出現	シュツゲン
合体	ガッタイ
告発	コクハツ
想定	ソウテイ
本格的	ホンカクテキ
正す	タダス
オナラ	オナラ
ライフ	ライフ
学院	ガクイン
見下す	ミクダス
資産	シサン
おとる	オトル
急ぎ	イソギ
演劇	エンゲキ
見当	ケントウ
貯金	チョキン
過激	カゲキ
アイザック	アイザック
ナンパ	ナンパ
ブーツ	ブーツ
合える	アエル
感情的	カンジョウテキ
手口	テグチ
良心	リョウシン
命の恩人	イノチノオンジン
ウエスト	ウエスト
お尻	オシリ
タイヘイ	タイヘイ
ばあさん	バアサン
まぁ	マァ
停電	テイデン
大喜び	オオヨロコビ
帰	キ
引き金	ヒキガネ
憧れ	アコガレ
スペシャル	スペシャル
たいへん	タイヘン
ふた	フタ
リュウ	リュウ
愚か者	オロカモノ
所有者	ショユウシャ
昨年	サクネン
見当たる	ミアタル
ファースト	ファースト
ブー	ブー
宛て	アテ
情	ジョウ
突撃	トツゲキ
テン	テン
兵隊	ヘイタイ
来月	ライゲツ
直面	チョクメン
電池	デンチ
くま	クマ
くらいなら	クライナラ
シアトル	シアトル
ソフト	ソフト
極めて	キワメテ
煮る	ニル
被告	ヒコク
解明	カイメイ
賄賂	ワイロ
いまだ	イマダ
パスワード	パスワード
まじる	マジル
大規模	ダイキボ
運べる	ハコベル
麗	レイ
ジーン	ジーン
けれども	ケレドモ
ユウ	ユウ
一種	イッシュ
三井	ミツイ
中毒	チュウドク
人助け	ヒトダスケ
分だけ	フンダケ
前方	ゼンポウ
報う	ムクウ
本性	ホンショウ
絶つ	タツ
証し	ショウシ
そそる	ソソル
ヤマ	ヤマ
一時	イチジ
児童	ジドウ
心の準備	ココロノジュンビ
手品	テジナ
最優先	サイユウセン
独占	ドクセン
終	オワリ
鼓動	コドウ
ご主人様	ゴシュジンサマ
ネックレス	ネックレス
頬	ホオ
マリオ	マリオ
ルース	ルース
初期	ショキ
引き出し	ヒキダシ
きち	キチ
その他	ソノホカ
ノイズ	ノイズ
ボストン	ボストン
われる	ワレル
名刺	メイシ
居所	イドコロ
張	チョウ
育ち	ソダチ
しょう	ショウ
に従って	ニシタガッテ
杏	アンズ
うめ	ウメ
スタジアム	スタジアム
パーカー	パーカー
パフォーマンス	パフォーマンス
ひとまず	ヒトマズ
柚	ユズ
盗賊	トウゾク
腰抜け	コシヌケ
ドローン	ドローン
図る	ハカル
孫悟空	ソンゴクウ
甘える	アマエル
キャッチ	キャッチ
ケガ人	ケガニン
ずる	ズル
住める	スメル
情け	ナサケ
かえって	カエッテ
コイル	コイル
ゴキブリ	ゴキブリ
健	タケシ
吐き気	ハキケ
尚	タカシ
白血球	ハッケッキュウ
真田	サナダ
解釈	カイシャク
いかにも	イカニモ
拳銃	ケンジュウ
欠席	ケッセキ
特製	トクセイ
笑	ワライ
見習う	ミナラウ
里子	サトコ
オムツ	オムツ
わたる	ワタル
今月	コンゲツ
佑	ユウ
勝る	マサル
嬢	ジョウ
定める	サダメル
愛せる	アイセル
ご協力	ゴキョウリョク
プライベート	プライベート
木曜	モクヨウ
来れる	コレル
空軍	クウグン
跋	バツ
お部屋	オヘヤ
傾ける	カタムケル
処女	ショジョ
労働者	ロウドウシャ
こぼす	コボス
人違い	ヒトチガイ
効果的	コウカテキ
同胞	ドウホウ
食い物	クイモノ
ドキュメンタリー	ドキュメンタリー
ボクシング	ボクシング
レーン	レーン
伝統的	デントウテキ
初恋	ハツコイ
虐殺	ギャクサツ
コメディ	コメディ
スペイン語	スペインゴ
サンフランシスコ	サンフランシスコ
シャロン	シャロン
ひたすら	ヒタスラ
メン	メン
拒絶	キョゼツ
物件	ブッケン
砕ける	クダケル
美紀	ミキ
返信	ヘンシン
迷い	マヨイ
ウィスコンシン	ウィスコンシン
エリート	エリート
画家	ガカ
かゆい	カユイ
乱す	ミダス
交通事故	コウツウジコ
競う	キソウ
お電話	オデンワ
ひょう	ヒョウ
晴らす	ハラス
決めつける	キメツケル
腹部	フクブ
要塞	ヨウサイ
ギャグ	ギャグ
スカイ	スカイ
中継	チュウケイ
剤	ザイ
振るう	フルウ
設立	セツリツ
錠	ジョウ
お祈り	オイノリ
くし	クシ
ドイツ人	ドイツニン
料金	リョウキン
正当	セイトウ
泊	ハク
無能	ムノウ
シドニー	シドニー
ワクチン	ワクチン
わらう	ワラウ
広める	ヒロメル
桐生	キリュウ
赤血球	セッケッキュウ
ヘザー	ヘザー
われわれ	ワレワレ
卑怯	ヒキョウ
基	モト
戦術	センジュツ
省	ショウ
神話	シンワ
芸能人	ゲイノウジン
アシュリー	アシュリー
カマ	カマ
ハナ	ハナ
ゆでる	ユデル
七海	シチウミ
引き換え	ヒキカエ
悪事	アクジ
殻	カラ
いと	イト
ばい	バイ
励ます	ハゲマス
地味	ジミ
市警	シケイ
採取	サイシュ
癒やし	ユヤシ
駆ける	カケル
あめ	アメ
お代わり	オカワリ
バースト	バースト
公式	コウシキ
名簿	メイボ
理屈	リクツ
盛大	セイダイ
アイルランド	アイルランド
お見舞い	オミマイ
溝	ミゾ
秋山	アキヤマ
アラーム	アラーム
マーサ	マーサ
所持	ショジ
サムライ	サムライ
ピンキー	ピンキー
不機嫌	フキゲン
乳	チチ
仕留める	シトメル
区域	クイキ
地下鉄	チカテツ
無知	ムチ
藤堂	トウドウ
詐欺師	サギシ
鶴	ツル
おりる	オリル
ナッツ	ナッツ
なんだか	ナンダカ
反論	ハンロン
守り	マモリ
恵み	メグミ
想像力	ソウゾウリョク
真理	シンリ
能	ノウ
アレン	アレン
叔母	オバ
吸引	キュウイン
小銭	コゼニ
小麦粉	コムギコ
所詮	ショセン
高麗	コウライ
クソガキ	クソガキ
ボロい	ボロイ
再婚	サイコン
圧倒	アットウ
埋葬	マイソウ
引き起こす	ヒキオコス
散々	サンザン
没収	ボッシュウ
菅原	スガワラ
風の音	カゼノオト
黄瀬	キセ
あっさり	アッサリ
かかわる	カカワル
ヘレン	ヘレン
予告	ヨコク
徳永	トクナガ
押収	オウシュウ
ボルト	ボルト
お迎え	オムカエ
シュー	シュー
パート	パート
めぐみ	メグミ
文章	ブンショウ
気持ちよい	キモチヨイ
組長	クミチョウ
卑劣	ヒレツ
反する	ハンスル
担当者	タントウシャ
治せる	ナオセル
産	サン
緋	ヒ
征服	セイフク
業務	ギョウム
気合	キアイ
済まない	スマナイ
アルコール	アルコール
イム	イム
ゾーン	ゾーン
制圧	セイアツ
売却	バイキャク
火山	カザン
誓って	チカッテ
ウルフ	ウルフ
ステラ	ステラ
偽装	ギソウ
手入れ	テイレ
望月	モチヅキ
正	セイ
見届ける	ミトドケル
隅	スミ
あぶる	アブル
愉快	ユカイ
未練	ミレン
面白	オモシロ
元カノ	モトカノ
報い	ムクイ
暗黒	アンコク
イルカ	イルカ
康一	コウイチ
絞める	シメル
見込み	ミコミ
述べる	ノベル
長引く	ナガビク
バカバカしい	バカバカシイ
激怒	ゲキド
見る目	ミルメ
ウィルソン	ウィルソン
竹山	タケヤマ
クワ	クワ
出版	シュッパン
稽古	ケイコ
若い頃	ワカイゴロ
韓国語	カンコクゴ
イイ	イイ
ガッツ	ガッツ
モーリス	モーリス
爆撃	バクゲキ
背景	ハイケイ
芸	ゲイ
ガイド	ガイド
くらう	クラウ
こぐ	コグ
スッキリ	スッキリ
だま	ダマ
ピース	ピース
プレゼン	プレゼン
ほお	ホオ
作り上げる	ツクリアゲル
分野	ブンヤ
恭	ヤス
遠ざける	トオザケル
飽和	ホウワ
ウォーカー	ウォーカー
ハト	ハト
ヘ	ヘ
人種差別	ジンシュサベツ
身勝手	ミガッテ
部族	ブゾク
セラ	セラ
使用人	シヨウニン
学者	ガクシャ
走り	ハシリ
限定	ゲンテイ
痕	アト
真っ赤	マッカ
福	フク
職務	ショクム
脂肪	シボウ
青春	セイシュン
シルバー	シルバー
優雅	ユウガ
比較	ヒカク
さまよう	サマヨウ
凪	ナギ
慎む	ツツシム
著者	チョシャ
鐘	カネ
トカゲ	トカゲ
リビング	リビング
寿司	スシ
弱	ジャク
時空	ジクウ
発動	ハツドウ
ボラ	ボラ
泣かせる	ナカセル
胎児	タイジ
シカ	シカ
ババ	ババ
晴	セイ
気取り	キドリ
衛兵	エイヘイ
言語	ゲンゴ
おわび	オワビ
まじめ	マジメ
めぐる	メグル
受かる	ウカル
振り向く	フリムク
発信	ハッシン
ためる	タメル
ヘッド	ヘッド
ミュージシャン	ミュージシャン
丁目	チョウメ
企む	タクラム
砲撃	ホウゲキ
縄	ナワ
腸	チョウ
設備	セツビ
ぬいぐるみ	ヌイグルミ
ハッキング	ハッキング
不当	フトウ
係員	カカリイン
引ける	ヒケル
留学	リュウガク
盛り上げる	モリアゲル
オファー	オファー
ちっちゃい	チッチャイ
ドッグ	ドッグ
沢村	サワムラ
盗聴	トウチョウ
食感	ショクカン
ジュリー	ジュリー
どなる	ドナル
ハンバーガー	ハンバーガー
マリファナ	マリファナ
姪	メイ
物資	ブッシ
退職	タイショク
それ以来	ソレイライ
トロフィー	トロフィー
前日	ゼンジツ
奈緒子	ナオコ
脱獄	ダツゴク
ぽい	ポイ
めったに	メッタニ
ライス	ライス
弁護人	ベンゴニン
投資家	トウシカ
症	ショウ
ご迷惑	ゴメイワク
ふだん	フダン
執行	シッコウ
残らず	ノコラズ
長生き	ナガイキ
中村	ナカムラ
引き離す	ヒキハナス
弱み	ヨワミ
栽培	サイバイ
泳げる	オヨゲル
診療所	シンリョウジョ
マネジャー	マネジャー
気に入り	キニイリ
紅葉	コウヨウ
翻訳	ホンヤク
養う	ヤシナウ
本題	ホンダイ
確定	カクテイ
頼	ライ
お越し	オコシ
ディフェンス	ディフェンス
フィッシュ	フィッシュ
手本	テホン
気温	キオン
秘める	ヒメル
立ち去る	タチサル
ロゴ	ロゴ
及川	オイカワ
墓地	ボチ
応募	オウボ
鷲	ワシ
冷酷	レイコク
止め	トメ
負傷者	フショウシャ
コンドーム	コンドーム
偽造	ギゾウ
幻想	ゲンソウ
教訓	キョウクン
無名	ムメイ
燈	トウ
高田	タカダ
お主	オシュ
クローン	クローン
乙女	オトメ
亡霊	ボウレイ
冒す	オカス
提示	テイジ
日本語	ニホンゴ
ジェン	ジェン
のせる	ノセル
一般的	イッパンテキ
上達	ジョウタツ
侵略	シンリャク
大型	オオガタ
火災	カサイ
オーラ	オーラ
かぜ	カゼ
回答	カイトウ
発売	ハツバイ
シル	シル
ハゲ	ハゲ
やしない	ヤシナイ
いっつも	イッツモ
バレー	バレー
久	キュウ
副作用	フクサヨウ
反則	ハンソク
安らか	ヤスラカ
成し遂げる	ナシトゲル
残業	ザンギョウ
親衛隊	シンエイタイ
キーン	キーン
だいたい	ダイタイ
フィルム	フィルム
立ち直る	タチナオル
おふくろ	オフクロ
サーフィン	サーフィン
ハンドル	ハンドル
リハビリ	リハビリ
奈緒美	ナオミ
妥協	ダキョウ
指名手配	シメイテハイ
松村	マツムラ
満点	マンテン
カクテル	カクテル
カッ	カッ
シャンプー	シャンプー
丁	チョウ
乗り	ノリ
承諾	ショウダク
案外	アンガイ
管理人	カンリニン
あるじ	アルジ
とれる	トレル
手前	テマエ
涼子	リョウコ
フレッド	フレッド
回せる	マワセル
女装	ジョソウ
輸送	ユソウ
そく	ソク
夢みる	ユメミル
攻略	コウリャク
数年前	スウネンマエ
気のせい	キノセイ
牛肉	ギュウニク
自立	ジリツ
首都	シュト
いじめ	イジメ
および	オヨビ
ぶち	ブチ
元カレ	モトカレ
大いに	オオイニ
引き上げる	ヒキアゲル
災難	サイナン
苦戦	クセン
螢	ホタル
麻酔	マスイ
やかましい	ヤカマシイ
狙撃	ソゲキ
風景	フウケイ
ひな	ヒナ
洋服	ヨウフク
真っ暗	マックラ
美術館	ビジュツカン
パンケーキ	パンケーキ
半田	ハンダ
密輸	ミツユ
美波	ミナミ
隆	タカシ
頭脳	ズノウ
アシスタント	アシスタント
エジプト	エジプト
ギャンブル	ギャンブル
セス	セス
先月	センゲツ
海崎	ウミサキ
皇子	オウジ
祐	スケ
臆病	オクビョウ
ボディ	ボディ
着地	チャクチ
バーバラ	バーバラ
匿名	トクメイ
路	ミチ
鷲巣	ワシス
いい加減	イイカゲン
フランス人	フランスニン
側近	ソッキン
後継者	コウケイシャ
施す	ホドコス
芽衣	メコロモ
おこ	オコ
とぶ	トブ
ユーモア	ユーモア
操	ミサオ
攻撃的	コウゲキテキ
泰山	タイザン
米田	ヨネダ
自動車	ジドウシャ
遊馬	ユウマ
ハード	ハード
入れ	イレ
取り消す	トリケス
結婚生活	ケッコンセイカツ
視点	シテン
単独	タンドク
合わせ	アワセ
忍び込む	シノビコム
疑惑	ギワク
コウモリ	コウモリ
令	レイ
前線	ゼンセン
武士	ブシ
法案	ホウアン
航空	コウクウ
あたる	アタル
何という	ナントイウ
期	キ
話し方	ハナシカタ
アイスクリーム	アイスクリーム
すず	スズ
大泉	オオイズミ
失	シツ
採る	トル
消防士	ショウボウシ
落とせる	オトセル
しのぶ	シノブ
ダダ	ダダ
ビート	ビート
合法	ゴウホウ
校長先生	コウチョウセンセイ
湯	ユ
獅子	シシ
チャラ	チャラ
よほど	ヨホド
作り方	ツクリカタ
杉	スギ
肝	キモ
裁判官	サイバンカン
なでる	ナデル
ローレライ	ローレライ
勝ち取る	カチトル
断れる	コトワレル
罰金	バッキン
集	シュウ
響き	ヒビキ
しき	シキ
ペガサス	ペガサス
木下	キノシタ
民衆	ミンシュウ
見上げる	ミアゲル
かね	カネ
モモ	モモ
危害	キガイ
厨房	チュウボウ
右腕	ミギウデ
慰め	ナグサメ
矛盾	ムジュン
解析	カイセキ
お手伝い	オテツダイ
人目	ヒトメ
早まる	ハヤマル
木場	キバ
気取る	キドル
頭部	トウブ
さらば	サラバ
捜し出す	サガシダス
横山	ヨコヤマ
管	カン
見方	ミカタ
記者会見	キシャカイケン
エスコバル	エスコバル
子孫	シソン
手上げ	テアゲ
春香	ハルカオリ
沈める	シズメル
立候補	リッコウホ
カウボーイ	カウボーイ
タナベ	タナベ
ミッチ	ミッチ
今日中に	キョウジュウニ
伊月	イガツ
体制	タイセイ
就任	シュウニン
クーパー	クーパー
スパイス	スパイス
つめ	ツメ
バーク	バーク
小森	コモリ
府	フ
見解	ケンカイ
ジャケット	ジャケット
トラウマ	トラウマ
もろい	モロイ
修	オサム
委ねる	ユダネル
漁師	リョウシ
ご苦労さん	ゴクロウサン
一杯	イッパイ
教官	キョウカン
総長	ソウチョウ
クラッカー	クラッカー
しかる	シカル
わする	ワスル
咆哮	ホウコウ
思いどおり	オモイドオリ
見抜く	ミヌク
７つ	７ツ
声援	セイエン
成分	セイブン
相	ソウ
荒らす	アラス
騒がしい	サワガシイ
にぎやか	ニギヤカ
よそ者	ヨソモノ
両者	リョウシャ
仕組む	シクム
反抗	ハンコウ
司祭	シサイ
引っ込む	ヒッコム
液体	エキタイ
火曜	カヨウ
縫合	ホウゴウ
警告音	ケイコクオン
いかなる	イカナル
エア	エア
乾燥	カンソウ
副社長	フクシャチョウ
劣る	オトル
生死	セイシ
すっきり	スッキリ
すんません	スンマセン
仕方なく	シカタナク
何しろ	ナニシロ
単語	タンゴ
学習	ガクシュウ
無責任	ムセキニン
雄たけび	オスタケビ
先ほど	サキホド
制度	セイド
厳重	ゲンジュウ
落書き	ラクガキ
間近	マジカ
アルゼンチン	アルゼンチン
カツオ	カツオ
テディ	テディ
とらわれる	トラワレル
マイル	マイル
刹那	セツナ
当選	トウセン
聞き出す	キキダス
いやがる	イヤガル
好意	コウイ
庭園	テイエン
政策	セイサク
新年	シンネン
知性	チセイ
お子さん	オコサン
警報音	ケイホウオン
頼もしい	タノモシイ
分かち	ワカチ
脳みそ	ノウミソ
離脱	リダツ
スクリーン	スクリーン
ソロ	ソロ
にらむ	ニラム
向	コウ
教科書	キョウカショ
聖域	セイイキ
費やす	ツイヤス
進路	シンロ
おなら	オナラ
ゆめ	ユメ
ワ	ワ
上海	シャンハイ
婆	バア
フットボール	フットボール
充電	ジュウデン
惑わす	マドワス
拘置所	コウチショ
歴史的	レキシテキ
美味しい	オイシイ
蚊	カ
ベンチ	ベンチ
リポーター	リポーター
体育	タイイク
無傷	ムキズ
防犯カメラ	ボウハンカメラ
ウォーター	ウォーター
スタンド	スタンド
スティーヴ	スティーヴ
やり直せる	ヤリナオセル
世界的	セカイテキ
受信	ジュシン
自動	ジドウ
鉄道	テツドウ
うし	ウシ
ゴッド	ゴッド
ラスベガス	ラスベガス
早	ソウ
精いっぱい	セイイッパイ
騎士団	キシダン
セン	セン
妹さん	イモウトサン
引き返す	ヒキカエス
新品	シンピン
航	コウ
シーザー	シーザー
ぶち壊す	ブチコワス
供給	キョウキュウ
始	シ
魚雷	ギョライ
ジャーン	ジャーン
バレンタイン	バレンタイン
仲良い	ナカヨイ
家事	カジ
泊まり	トマリ
線路	センロ
アカデミー	アカデミー
ケア	ケア
ノド	ノド
上官	ジョウカン
感染症	カンセンショウ
映画館	エイガカン
粒	ツブ
髪型	カミガタ
グリッド	グリッド
すする	ススル
ひきょう	ヒキョウ
ボックス	ボックス
ロデオ	ロデオ
何事も	ナニゴトモ
整形	セイケイ
昨晩	サクバン
特殊部隊	トクシュブタイ
血痕	ケッコン
豚肉	ブタニク
カップケーキ	カップケーキ
ジャズ	ジャズ
ソーダ	ソーダ
パンティ	パンティ
まとまる	マトマル
早朝	ソウチョウ
自己	ジコ
カラー	カラー
たった今	タッタイマ
ファック	ファック
ベビー	ベビー
まぶしい	マブシイ
ヤリ	ヤリ
家畜	カチク
毎月	マイツキ
秀吉	ヒデキチ
魅了	ミリョウ
カサ	カサ
キック	キック
ゴマ	ゴマ
トロール	トロール
檻	ラン
溶かす	トカス
あか	アカ
おの	オノ
判定	ハンテイ
本社	ホンシャ
決定的	ケッテイテキ
綾乃	アヤノ
うてる	ウテル
タツミ	タツミ
ハリス	ハリス
めまい	メマイ
反乱軍	ハンラングン
柴田	シバタ
生産	セイサン
羽川	ハガワ
アメフト	アメフト
いそ	イソ
しょうゆ	ショウユ
取り込む	トリコム
声明	セイメイ
縄張り	ナワバリ
守護	シュゴ
専念	センネン
弾丸	ダンガン
投入	トウニュウ
退場	タイジョウ
しっこ	シッコ
分子	ブンシ
大好物	ダイコウブツ
絶好	ゼッコウ
イースト	イースト
強要	キョウヨウ
アップル	アップル
くだす	クダス
つむぐ	ツムグ
ヒマ	ヒマ
フロア	フロア
リュック	リュック
埋まる	ウマル
天道	テンドウ
失恋	シツレン
性別	セイベツ
良好	リョウコウ
オッパイ	オッパイ
キャンディ	キャンディ
フランシス	フランシス
ホッケー	ホッケー
上手く	ウマク
容器	ヨウキ
想い	オモイ
汚れ	ヨゴレ
視界	シカイ
きゃあ	キャア
スキャンダル	スキャンダル
唯	タダ
照れる	テレル
罰する	バツスル
順	ジュン
トーク	トーク
ブース	ブース
プラズマ	プラズマ
不審	フシン
吾	ワレ
害	ガイ
脱げる	ヌゲル
長男	チョウナン
キーボード	キーボード
コレクション	コレクション
フェラ	フェラ
大杉	オオスギ
構成	コウセイ
焦げる	コゲル
狩る	カル
相撲	スモウ
細工	サイク
見送る	ミオクル
身近	ミジカ
ハサミ	ハサミ
少	ショウ
武田	タケダ
留める	トドメル
竜崎	リュウガサキ
観光客	カンコウキャク
スパルタ	スパルタ
バロン	バロン
何人も	ナンニンモ
出し	ダシ
可哀想	カワイソウ
感知	カンチ
クローゼット	クローゼット
我が子	ワガコ
敷地	シキチ
時間のムダ	ジカンノムダ
時間の問題	ジカンノモンダイ
スプレー	スプレー
タイムマシン	タイムマシン
に従い	ニシタガイ
後方	コウホウ
統一	トウイツ
オーダー	オーダー
オランダ	オランダ
キャラクター	キャラクター
封筒	フウトウ
敗退	ハイタイ
正しく	タダシク
通せる	トウセル
イラク	イラク
はやい	ハヤイ
区別	クベツ
回数	カイスウ
大使館	タイシカン
斉藤	サイトウ
真夜中	マヨナカ
モスクワ	モスクワ
ラウンジ	ラウンジ
人間界	ニンゲンカイ
吸い込む	スイコム
年下	トシシタ
起	キ
防げる	フセゲル
ジョーダン	ジョーダン
ミッキー	ミッキー
もどる	モドル
レナード	レナード
旧	キュウ
痛めつける	イタメツケル
頻繁	ヒンパン
イサミ	イサミ
サソリ	サソリ
人達	ヒトタチ
改める	アラタメル
永久	エイキュウ
海底	カイテイ
白石	シロイシ
表紙	ヒョウシ
遂げる	トゲル
フォロー	フォロー
切符	キップ
剃る	ソル
怪しむ	アヤシム
懲役	チョウエキ
斬新	ザンシン
無意識	ムイシキ
粒子	リュウシ
通訳	ツウヤク
遠慮なく	エンリョナク
ウェルズ	ウェルズ
将校	ショウコウ
平穏	ヘイオン
思い知る	オモイシル
水分	スイブン
見極める	ミキワメル
おやっ	オヤッ
お金持ち	オカネモチ
バグ	バグ
バケツ	バケツ
壊滅	カイメツ
数値	スウチ
生理	セイリ
遺族	イゾク
頂上	チョウジョウ
セーター	セーター
ひむ	ヒム
浄化	ジョウカ
海賊王	カイゾクオウ
真似	マネ
アジト	アジト
こす	コス
保釈	ホシャク
勇	イサミ
懸念	ケネン
逃げ	ニゲ
おわる	オワル
お送り	オオクリ
不自然	フシゼン
洗脳	センノウ
立花	タチバナ
きける	キケル
ギャラ	ギャラ
コロニー	コロニー
つきあい	ツキアイ
基礎	キソ
奨学金	ショウガクキン
断つ	タツ
私自身	ワタシジシン
クラン	クラン
シリア	シリア
セクハラ	セクハラ
プライバシー	プライバシー
リ	リ
入力	ニュウリョク
北村	キタムラ
取り調べ	トリシラベ
口笛	クチブエ
手出し	テダシ
舞う	マウ
パズル	パズル
リットル	リットル
出直す	デナオス
呼び出し	ヨビダシ
真っ白	マッシロ
竹	タケ
経験者	ケイケンシャ
電力	デンリョク
アザ	アザ
ウォール	ウォール
ティア	ティア
らく	ラク
冴子	サエコ
取り付ける	トリツケル
各自	カクジ
断言	ダンゲン
親方	オヤカタ
調和	チョウワ
アイテム	アイテム
アキ	アキ
ウィリアムズ	ウィリアムズ
キメる	キメル
ゴリ	ゴリ
デルタ	デルタ
ひま	ヒマ
ヘリコプター	ヘリコプター
恩返し	オンガエシ
授ける	サズケル
活動家	カツドウカ
航海	コウカイ
しく	シク
なぐ	ナグ
バッテリー	バッテリー
ばら	バラ
ピラフ	ピラフ
出撃	シュツゲキ
引き続き	ヒキツヅキ
色んな	イロンナ
鈍い	ニブイ
カルメン	カルメン
ケーブル	ケーブル
ジャネット	ジャネット
ドナルド	ドナルド
ヒザ	ヒザ
出力	シュツリョク
勤める	ツトメル
吹き飛ばす	フキトバス
帯	オビ
祐子	ユウコ
遊べる	アソベル
酒場	サカバ
鏑木	カブラキ
全開	ゼンカイ
助け合う	タスケアウ
瀬	セ
解説	カイセツ
鞠	マリ
いつく	イツク
サングラス	サングラス
果てる	ハテル
楽屋	ガクヤ
裁き	サバキ
ダイヤモンド	ダイヤモンド
パネル	パネル
ほっと	ホット
大介	ダイスケ
工夫	クフウ
広報	コウホウ
手元	テモト
粉々	コナゴナ
細菌	サイキン
薬局	ヤッキョク
講師	コウシ
ムラサキ	ムラサキ
代理人	ダイリニン
動き出す	ウゴキダス
名付ける	ナヅケル
大和	ヤマト
岡	オカ
昇る	ノボル
トロイ	トロイ
呪	ジュ
宮城	ミヤギ
未熟	ミジュク
水晶	スイショウ
理絵	リエ
いわく	イワク
引き取り	ヒキトリ
探索	タンサク
教皇	キョウコウ
キラー	キラー
学費	ガクヒ
心強い	ココロヅヨイ
汝	ナンジ
金曜日	キンヨウビ
カルテ	カルテ
まとう	マトウ
帳簿	チョウボ
懲りる	コリル
現実的	ゲンジツテキ
鉱山	コウザン
駐車	チュウシャ
騒動	ソウドウ
カウンセラー	カウンセラー
キャン	キャン
パンダ	パンダ
傷口	キズグチ
別名	ベツメイ
卒	ソツ
推理	スイリ
異星人	イセイジン
融資	ユウシ
裏口	ウラグチ
タウン	タウン
チェンジ	チェンジ
ポスト	ポスト
丑	ウシ
増加	ゾウカ
小枝	ショウエダ
竜一	リュウイチ
あま	アマ
オーク	オーク
ション	ション
ブリタニア	ブリタニア
丞相	ジョウショウ
同類	ドウルイ
弱虫	ヨワムシ
格闘	カクトウ
気遣い	キヅカイ
監獄	カンゴク
翌朝	ヨクチョウ
記す	シルス
オーライ	オーライ
キューバ	キューバ
グローブ	グローブ
コルト	コルト
チェス	チェス
介入	カイニュウ
以前に	イゼンニ
吉岡	ヨシオカ
和之	カズユキ
枯れる	カレル
発掘	ハックツ
隙間	スキマ
プレイヤー	プレイヤー
マーガレット	マーガレット
幹	カン
無縁	ムエン
王冠	オウカン
編	ヘン
逝く	イク
阿部	アベ
づける	ヅケル
といった	トイッタ
フォーク	フォーク
執筆	シッピツ
担任	タンニン
探検	タンケン
損ねる	ソコネル
数カ月	カズカガツ
棺	ヒツギ
漫才	マンザイ
ホリー	ホリー
不死身	フジミ
刺激的	シゲキテキ
思い知らせる	オモイシラセル
旅立つ	タビダツ
超能力	チョウノウリョク
重荷	オモニ
グズグズ	グズグズ
ハーブ	ハーブ
岸	キシ
日付	ヒヅケ
何回も	ナンカイモ
塚	ツカ
安斎	アンザイ
木材	モクザイ
生存	セイゾン
経る	ヘル
菓子	カシ
リース	リース
兄妹	キョウダイ
各地	カクチ
授かる	サズカル
片づく	カタヅク
金魚	キンギョ
すぐそこ	スグソコ
ネオ	ネオ
みちる	ミチル
やらかす	ヤラカス
ロシア人	ロシアニン
何度でも	ナンドデモ
共演	キョウエン
吐き出す	ハキダス
札	サツ
こんど	コンド
フルーツ	フルーツ
ライラ	ライラ
化する	カスル
叶	カノウ
扇	オウギ
概念	ガイネン
毎度	マイド
江戸	エド
注入	チュウニュウ
阿る	アル
鶏肉	トリニク
あがる	アガル
オリンピック	オリンピック
かわいがる	カワイガル
不適切	フテキセツ
印刷	インサツ
愚	グ
綺	キ
要は	ヨウハ
鷹	タカ
ケル	ケル
ごきげんよう	ゴキゲンヨウ
トレイシー	トレイシー
叶う	カナウ
支え	ササエ
横取り	ヨコドリ
泣ける	ナケル
生息	セイソク
言い分	イイブン
シャノン	シャノン
しろい	シロイ
みほ	ミホ
周波数	シュウハスウ
植樹	ショクジュ
機密	キミツ
武術	タケシジュツ
独房	ドクボウ
班長	ハンチョウ
軍事	グンジ
通れる	トウレル
お水	オミズ
スクープ	スクープ
デー	デー
全額	ゼンガク
編集者	ヘンシュウシャ
透明	トウメイ
万一	マンイチ
善良	ゼンリョウ
坊ちゃん	ボウチャン
堀	ホリ
空中	クウチュウ
蒙る	コウムル
あーん	アーン
ねえさん	ネエサン
不運	フウン
中川	ナカガワ
人手	ヒトデ
点検	テンケン
義姉	ギシ
農業	ノウギョウ
追求	ツイキュウ
かげ	カゲ
スリ	スリ
ちょいと	チョイト
っ子	ッコ
パレード	パレード
ベテラン	ベテラン
兆候	チョウコウ
哉	ヤ
広島	コウシマ
無数	ムスウ
香織	カオリ
としたら	トシタラ
好奇心	コウキシン
穴見	アナケン
精神科医	セイシンカイ
苺	イチゴ
解剖	カイボウ
詩人	シジン
たれる	タレル
ファミリー	ファミリー
予定どおり	ヨテイドオリ
果たせる	ハタセル
私生活	シセイカツ
腐敗	フハイ
覆面	フクメン
釣れる	ツレル
障る	サワル
カトリック	カトリック
忠誠心	チュウセイシン
海原	ウナバラ
禁物	キンモツ
重なる	オモナル
アンドレ	アンドレ
シーツ	シーツ
なおさら	ナオサラ
プロム	プロム
ムーン	ムーン
五十嵐	イガラシ
坂本	サカモト
援軍	エングン
物体	ブッタイ
空想	クウソウ
自分の力	ジブンノチカラ
道場	ドウジョウ
閉ざす	トザス
じゅん	ジュン
向上	コウジョウ
地響き	ジヒビキ
時間切れ	ジカンギレ
本質	ホンシツ
毬	マリ
活用	カツヨウ
男前	オトコマエ
病む	ヤム
連載	レンサイ
遺言	ユイゴン
鎮痛剤	チンツウザイ
あし	アシ
サークル	サークル
平均	ヘイキン
食らえる	クラエル
三浦	ミウラ
代役	ダイヤク
作成	サクセイ
宴	ウタゲ
継	ケイ
転落	テンラク
錬金術師	レンキンジュツシ
トルコ	トルコ
宿る	ヤドル
集中力	シュウチュウリョク
おかみ	オカミ
カツラ	カツラ
ぐち	グチ
げっ	ゲッ
住まい	スマイ
岡田	オカダ
延長	エンチョウ
技術者	ギジュツシャ
改良	カイリョウ
武道	ブドウ
称賛	ショウサン
管轄	カンカツ
エコー	エコー
どうにも	ドウニモ
パンパン	パンパン
会談	カイダン
侵攻	シンコウ
っちょ	ッチョ
ヨリ	ヨリ
レギュラー	レギュラー
収容所	シュウヨウジョ
盗る	トル
考	コウ
配慮	ハイリョ
イタズラ	イタズラ
お悔やみ	オクヤミ
シリアル	シリアル
シンデレラ	シンデレラ
フレア	フレア
ムラ	ムラ
後退	コウタイ
星奈	ホシナ
破産	ハサン
頑丈	ガンジョウ
シングル	シングル
みっともない	ミットモナイ
会見	カイケン
昇	ノボル
適任	テキニン
くれぐれも	クレグレモ
スコットランド	スコットランド
ピクニック	ピクニック
ムード	ムード
何かと	ナニカト
北海道	ホッカイドウ
抗争	コウソウ
神原	カミハラ
箸	ハシ
重視	ジュウシ
あご	アゴ
エンジニア	エンジニア
コップ	コップ
マザー	マザー
付け	ツケ
密売	ミツバイ
影響力	エイキョウリョク
節	フシ
見なす	ミナス
遮断	シャダン
いす	イス
偽者	ニセモノ
処方	ショホウ
告訴	コクソ
悪意	アクイ
東堂	ヒガシドウ
近	キン
かぐ	カグ
ミナ	ミナ
包帯	ホウタイ
団員	ダンイン
展示	テンジ
留守番	ルスバン
真理亜	シンリア
輸血	ユケツ
鬼塚	オニヅカ
アイツ	アイツ
ジョージア	ジョージア
ラマ	ラマ
主治医	シュジイ
偽る	イツワル
創る	ツクル
原作	ゲンサク
大王	ダイオウ
幅	ハバ
彩	サイ
恵美	エミ
打撃	ダゲキ
暖炉	ダンロ
欺く	アザムク
清潔	セイケツ
臓器	ゾウキ
賞品	ショウヒン
邪見	ジャケン
鳴く	ナク
お笑い	オワライ
ジェフリー	ジェフリー
ちい	チイ
ややこしい	ヤヤコシイ
ロッキー	ロッキー
一馬	イチバ
久保	クボ
占領	センリョウ
掲げる	カカゲル
農民	ノウミン
エリ	エリ
ビートルズ	ビートルズ
任命	ニンメイ
労働	ロウドウ
小型	コガタ
常連	ジョウレン
恩人	オンジン
科学的	カガクテキ
キュート	キュート
クララ	クララ
ティッシュ	ティッシュ
ビジョン	ビジョン
ブドウ	ブドウ
ホープ	ホープ
ライフル	ライフル
リモコン	リモコン
伯父さん	オジサン
小泉	コイズミ
強敵	キョウテキ
放出	ホウシュツ
討論	トウロン
お化け	オバケ
ジャガイモ	ジャガイモ
傲慢	ゴウマン
入場	ニュウジョウ
前半	ゼンハン
差し入れ	サシイレ
旅館	リョカン
窪	クボ
アイリス	アイリス
ウェスト	ウェスト
ささい	ササイ
シェア	シェア
しな	シナ
ノース	ノース
大砲	タイホウ
明ける	アケル
王族	オウゾク
食い止める	クイヤメル
ふと	フト
中東	チュウトウ
喧嘩	ケンカ
徳	トク
慕う	シタウ
柊	ヒイラギ
オードリー	オードリー
キリル	キリル
一見	イッケン
完	カン
是非	ゼヒ
解き放つ	トキホウッツ
連	レン
かっこ	カッコ
バディ	バディ
不自由	フジユウ
共和党	キョウワトウ
典型的	テンケイテキ
担う	ニナウ
聖人	セイジン
くるみ	クルミ
ばく	バク
仙道	センドウ
動脈	ドウミャク
孤児	コジ
かせる	カセル
きた	キタ
クリニック	クリニック
サウス	サウス
しいる	シイル
ぜんぶ	ゼンブ
そういうもの	ソウイウモノ
仮説	カセツ
凄い	スゴイ
抑制	ヨクセイ
法則	ホウソク
面倒くさい	メンドウクサイ
あける	アケル
イモ	イモ
シートベルト	シートベルト
ダメダメ	ダメダメ
ちぎる	チギル
ネス	ネス
マント	マント
接す	セッス
石油	セキユ
見殺し	ミゴロシ
インターネット	インターネット
ホルモン	ホルモン
まかせる	マカセル
各国	カッコク
感触	カンショク
病室	ビョウシツ
精一杯	セイイッパイ
補佐	ホサ
見せかける	ミセカケル
負	フ
足止め	アシドメ
遺書	イショ
いい天気	イイテンキ
かじ	カジ
ケリ	ケリ
ワゴン	ワゴン
協定	キョウテイ
子供達	コドモタチ
黄泉	ヨミ
けんか	ケンカ
ターン	ターン
ミュージカル	ミュージカル
ロウソク	ロウソク
伸明	ノブアキ
卒業式	ソツギョウシキ
茶色	チャイロ
ホーク	ホーク
内巻	ナイカン
呉	クレ
木暮	キクレ
申し出	モウシデ
足首	アシクビ
飼い主	カイヌシ
サバ	サバ
すき	スキ
ファー	ファー
乗馬	ジョウバ
宇佐美	ウサミ
放射線	ホウシャセン
蘇生	ソセイ
路上	ロジョウ
近道	チカミチ
カボチャ	カボチャ
デスク	デスク
パキスタン	パキスタン
ぶち込む	ブチコム
ホットドッグ	ホットドッグ
地球上	チキュウジョウ
沖縄	オキナワ
潜水艦	センスイカン
総督	ソウトク
キクチ	キクチ
グレイス	グレイス
荒巻	アラマキ
観	カン
か所	カトコロ
サブ	サブ
ステーション	ステーション
やや	ヤヤ
司令	シレイ
存じる	ゾンジル
アルバ	アルバ
ゴールデン	ゴールデン
コブラ	コブラ
ほんの少し	ホンノスコシ
実際に	ジッサイニ
尿	ニョウ
東部	トウブ
楚	ソ
見くびる	ミクビル
あさって	アサッテ
インチキ	インチキ
まゆみ	マユミ
協力者	キョウリョクシャ
大山	オオヤマ
平気で	ヘイキデ
新世界	シンセカイ
由来	ユライ
苹果	苹カ
選抜	センバツ
ウル	ウル
何らかの	ナンラカノ
元どおり	モトドオリ
和子	カズコ
形跡	ケイセキ
思うに	オモウニ
暴力的	ボウリョクテキ
証拠品	ショウコヒン
違和感	イワカン
離陸	リリク
ちょい	チョイ
はやる	ハヤル
メタ	メタ
レイン	レイン
ロロ	ロロ
好きなように	スキナヨウニ
法師	ホウシ
難い	ガタイ
イド	イド
ずーっと	ズーット
パール	パール
ユダヤ	ユダヤ
体温	タイオン
夏海	ナツウミ
後任	コウニン
王さま	オウサマ
生徒会長	セイトカイチョウ
遅れ	オクレ
クレイグ	クレイグ
ひも	ヒモ
ホログラム	ホログラム
中華	チュウカ
大違い	オオチガイ
奇襲	キシュウ
張り切る	ハリキル
特権	トッケン
仮装	カソウ
投獄	トウゴク
毛皮	ケガワ
遺跡	イセキ
ワッフル	ワッフル
全世界	ゼンセカイ
写真家	シャシンカ
履歴	リレキ
形成	ケイセイ
潔白	ケッパク
ガラクタ	ガラクタ
クライ	クライ
レジ	レジ
中途半端	チュウトハンパ
退避	タイヒ
高尾	タカオ
どちら様	ドチラサマ
回路	カイロ
戦艦	センカン
放り出す	ホウリダス
浴室	ヨクシツ
生き抜く	イキヌク
たべる	タベル
モール	モール
レックス	レックス
取り入れる	トリイレル
召す	メス
太鼓	タイコ
謙虚	ケンキョ
進	ススム
陵南	リョウミナミ
非常	ヒジョウ
うぬぼれる	ウヌボレル
ヒール	ヒール
むちゃ	ムチャ
不吉	フキツ
好都合	コウツゴウ
宇宙飛行士	ウチュウヒコウシ
正宗	マサムネ
あやめ	アヤメ
オースティン	オースティン
そりゃあ	ソリャア
ポー	ポー
切り替える	キリカエル
利口	リコウ
叔母さん	オバサン
台北	タイホク
律	リツ
損失	ソンシツ
称号	ショウゴウ
米国人	ベイコクジン
結晶	ケッショウ
預言者	ヨゲンモノ
カリー	カリー
しんぱい	シンパイ
右側	ミギガワ
叶える	カナエル
怠る	オコタル
星人	セイジン
気遣う	キヅカウ
田代	タシロ
経緯	ケイイ
クリーン	クリーン
シャーリー	シャーリー
パット	パット
ハラ	ハラ
ハンス	ハンス
ルピー	ルピー
依存	イゾン
前後	ゼンゴ
弾ける	ヒケル
真っすぐ	マコトッスグ
騙す	ダマス
アブノーマル	アブノーマル
コル	コル
ソニー	ソニー
分解	ブンカイ
収集	シュウシュウ
受け取れる	ウケトレル
甘やかす	アマヤカス
適応	テキオウ
お疲れ様	オツカレサマ
クッソ	クッソ
レア	レア
技師	ギシ
民族	ミンゾク
涼	リョウ
由佳	ユカ
西部	セイブ
イタリア人	イタリアニン
おとぎ話	オトギハナシ
かのように	カノヨウニ
初心者	ショシンシャ
加えて	クワエテ
搭載	トウサイ
獣医	ジュウイ
真白	マッシロ
継続	ケイゾク
締める	シメル
身分証	ミブンショウ
ばちゃん	バチャン
取り乱す	トリミダス
散らす	チラス
気味	キミ
用心棒	ヨウジンボウ
眼	メ
研	ケン
自爆	ジバク
藤宮	フジミヤ
見かけ	ミカケ
サンダー	サンダー
なぞ	ナゾ
まゆ	マユ
出馬	シュツバ
切り裂く	キリサク
大根	ダイコン
小声	コゴエ
建築家	ケンチクカ
抜かす	ヌカス
数日後	スウジツゴ
月琴	ガツコン
深める	フカメル
秘訣	ヒケツ
竜巻	タツマキ
義兄	ギアニ
道のり	ミチノリ
コケ	コケ
ドミニク	ドミニク
亀裂	キレツ
勇利	イサミリ
引き	ヒキ
装着	ソウチャク
踏み込む	フミコム
高校時代	コウコウジダイ
アタック	アタック
かぁ	カァ
キット	キット
キャベツ	キャベツ
ちょうらく	チョウラク
テレビ局	テレビキョク
マグロ	マグロ
レイラ	レイラ
悪い知らせ	ワルイシラセ
番地	バンチ
ガイ	ガイ
カンナ	カンナ
ユニコーン	ユニコーン
ローレル	ローレル
不可欠	フカケツ
別々	ベツベツ
小池	コイケ
物騒	ブッソウ
理科	リカ
盃	ハイ
設計図	セッケイズ
お出かけ	オデカケ
何日も	ナンニチモ
収監	シュウカン
長楽	チョウラク
ミロ	ミロ
中西	ナカニシ
堅次	ケンツギ
急げる	イソゲル
敗れる	ヤブレル
朝倉	アサクラ
野崎	ノザキ
たて	タテ
ペイント	ペイント
ぽん	ポン
ユニット	ユニット
情報源	ジョウホウゲン
拙者	セッシャ
直撃	チョクゲキ
葉月	ハヅキ
選び	エラビ
くつ	クツ
こする	コスル
であれば	デアレバ
ポジション	ポジション
処罰	ショバツ
失業	シツギョウ
規定	キテイ
返し	カエシ
頂ける	イタダケル
エリー	エリー
サーバー	サーバー
チームワーク	チームワーク
トラップ	トラップ
ヒヒ	ヒヒ
レズビアン	レズビアン
切り札	キリフダ
引っ掛かる	ヒッカカル
既婚者	キコンシャ
親密	シンミツ
シミ	シミ
ぜったい	ゼッタイ
そんで	ソンデ
マーリン	マーリン
一刻も早く	イッコクモハヤク
浮かれる	ウカレル
近頃	チカゴロ
どれほど	ドレホド
上回る	ウワマワル
劉	リュウ
年頃	ネンゴロ
新曲	シンキョク
速報	ソクホウ
高野	タカノ
スクール	スクール
ベント	ベント
今どき	イマドキ
映す	ウツス
歩き回る	アルキマワル
混む	コム
ある程度	アルテイド
ハッチ	ハッチ
凍える	コゴエル
売買	バイバイ
専攻	センコウ
月火	ゲツカ
神社	ジンジャ
精	セイ
被る	コウムル
ウィリー	ウィリー
トーン	トーン
ヨーグルト	ヨーグルト
売春	バイシュン
敏感	ビンカン
新聞社	シンブンシャ
長所	チョウショ
ドロシー	ドロシー
刺客	シカク
反逆者	ハンギャクシャ
市内	シナイ
敗者	ハイシャ
教徒	キョウト
数か月	スウカゲツ
検出	ケンシュツ
パーフェクト	パーフェクト
戦闘機	セントウキ
洗浄	センジョウ
滝沢	タキザワ
精子	セイシ
納	ノウ
美冬	ビフユ
財宝	ザイホウ
スマイル	スマイル
ブレイン	ブレイン
押し寄せる	オシヨセル
新型	シンガタ
永	エイ
現役	ゲンエキ
異動	イドウ
ぐっすり	グッスリ
クリストファー	クリストファー
ヘル	ヘル
を通じて	ヲツウジテ
副会長	フクカイチョウ
創造	ソウゾウ
消	ショウ
素手	スデ
胸部	キョウブ
華やか	ハナヤカ
追いつける	オイツケル
おき	オキ
グリフィン	グリフィン
っきり	ッキリ
トレーナー	トレーナー
住宅	ジュウタク
倒	トウ
執る	トル
天然	テンネン
測定	ソクテイ
さっそく	サッソク
ヒロイン	ヒロイン
ファイナル	ファイナル
最愛	サイアイ
種目	シュモク
過ぎ	スギ
ありのまま	アリノママ
グロリア	グロリア
すねる	スネル
タイムズ	タイムズ
フミ	フミ
万事	バンジ
二日酔い	フツカヨイ
恐れ入る	オソレイル
絶品	ゼッピン
芽衣子	メコロモコ
障害物	ショウガイブツ
アリゾナ	アリゾナ
コソコソ	コソコソ
しかける	シカケル
スロー	スロー
三郎	サブロウ
代金	ダイキン
国外	コクガイ
辺	ヘン
あいだ	アイダ
かする	カスル
カミラ	カミラ
ガレージ	ガレージ
共犯者	キョウハンシャ
支配人	シハイニン
機器	キキ
江原	エバラ
混ざる	マザル
群	グン
魔界	マカイ
テル	テル
ノブ	ノブ
ヒューズ	ヒューズ
ベール	ベール
ロッド	ロッド
券	ケン
千葉	チバ
定義	テイギ
うろつく	ウロツク
テク	テク
ネルソン	ネルソン
フィギュア	フィギュア
乗り切る	ノリキル
健全	ケンゼン
名義	メイギ
気分転換	キブンテンカン
相馬	ソウマ
見送り	ミオクリ
覚醒	カクセイ
赤毛	アカゲ
部署	ブショ
韓国人	カンコクジン
ツケ	ツケ
フライパン	フライパン
もう一つ	モウヒトツ
凶悪	キョウアク
改革	カイカク
料	リョウ
未成年	ミセイネン
褒美	ホウビ
見物	ケンブツ
音無	オトナシ
お手本	オテホン
つなぎ	ツナギ
バーンズ	バーンズ
ビショップ	ビショップ
反射	ハンシャ
控えめ	ヒカエメ
流出	リュウシュツ
特集	トクシュウ
雇い主	ヤトイヌシ
ピッチャー	ピッチャー
付き添う	ツキソウ
困惑	コンワク
大輝	ダイテル
実践	ジッセン
棘	ナツメ
窮地	キュウチ
脱落者	ダツラクシャ
見知らぬ	ミシラヌ
部外者	ブガイシャ
すさまじい	スサマジイ
スリル	スリル
レポート	レポート
卒業生	ソツギョウセイ
大衆	タイシュウ
えん	エン
げんき	ゲンキ
にげる	ニゲル
小隊	ショウタイ
摂取	セッシュ
緑色	リョクショク
誘拐犯	ユウカイハン
いちご	イチゴ
シフト	シフト
たくましい	タクマシイ
ミドリ	ミドリ
一色	イッショク
思想	シソウ
染まる	ソマル
極道	ゴクドウ
次期	ジキ
洗練	センレン
腕前	ウデマエ
表示	ヒョウジ
負かす	マカス
グレー	グレー
フェンス	フェンス
やけど	ヤケド
やたら	ヤタラ
嘆く	ナゲク
弁償	ベンショウ
町長	チョウチョウ
窃盗	セットウ
繁栄	ハンエイ
サーバル	サーバル
引き渡し	ヒキワタシ
衝撃的	ショウゲキテキ
貧困	ヒンコン
あえぎ声	アエギコエ
スカ	スカ
どん底	ドンソコ
一般人	イッパンジン
想定外	ソウテイソト
浸る	ヒタル
補	ホ
評決	ヒョウケツ
ささやく	ササヤク
ドリンク	ドリンク
ポップコーン	ポップコーン
一旦	イッタン
生き残れる	イキノコレル
禁煙	キンエン
細部	サイブ
華麗	カレイ
起こせる	オコセル
アーチー	アーチー
おり	オリ
ジョイ	ジョイ
セバスチャン	セバスチャン
ナノ	ナノ
パトロール	パトロール
引き寄せる	ヒキヨセル
志願	シガン
想う	オモウ
掛かる	カカル
構え	カマエ
紛れる	マギレル
複製	フクセイ
革	カワ
はぐれる	ハグレル
リョウ	リョウ
強大	キョウダイ
連勝	レンショウ
きのう	キノウ
だの	ダノ
味付け	アジツケ
基金	キキン
屁	ヘ
幸世	サチヨ
関西	カンサイ
響	キョウ
アトランタ	アトランタ
さえずり	サエズリ
そる	ソル
ダッシュ	ダッシュ
チャージ	チャージ
人体	ジンタイ
看病	カンビョウ
篠原	シノハラ
食わせる	クワセル
スイカ	スイカ
山積み	ヤマヅミ
強気	ツヨキ
救済	キュウサイ
策略	サクリャク
言い聞かせる	イイキカセル
なんとなく	ナントナク
ブサイク	ブサイク
ペンキ	ペンキ
ボクサー	ボクサー
マウス	マウス
千石	センゴク
定番	テイバン
打	ダ
正反対	セイハンタイ
美穂	ミホ
設ける	モウケル
にる	ニル
よしっ	ヨシッ
傾向	ケイコウ
極	キョク
絵画	カイガ
高額	コウガク
エンジェル	エンジェル
かぎ	カギ
なじむ	ナジム
バスター	バスター
ミント	ミント
三宅	ミヤケ
必須	ヒッス
裂く	サク
陽気	ヨウキ
魚住	ウオズミ
スワン	スワン
ロペス	ロペス
ワトソン	ワトソン
丈夫	ジョウブ
孝	タカシ
屋台	ヤタイ
皐月	ゴガツ
船員	センイン
行事	ギョウジ
議題	ギダイ
降下	コウカ
ガンガン	ガンガン
こんな風に	コンナカゼニ
しゃべれる	シャベレル
ダニ	ダニ
のち	ノチ
はつ	ハツ
ラッシュ	ラッシュ
子猫	コネコ
宿命	シュクメイ
真に	マコトニ
絶える	タエル
舟	フネ
誠意	セイイ
追	ツイ
除去	ジョキョ
おもう	オモウ
キツネ	キツネ
すなわち	スナワチ
にゃん	ニャン
リーチ	リーチ
早起き	ハヤオキ
次長	ジチョウ
経費	ケイヒ
雄基	ユウキ
さかい	サカイ
サマ	サマ
なりに	ナリニ
北条	ホウジョウ
戻り	モドリ
早々	ソウソウ
点火	テンカ
真奈	マナ
者ども	モノドモ
オチ	オチ
クローバー	クローバー
しぶとい	シブトイ
バッド	バッド
ヒューストン	ヒューストン
価値観	カチカン
刑期	ケイキ
模型	モケイ
秦	シン
資源	シゲン
龍也	タツヤ
スイート	スイート
どー	ドー
ドリル	ドリル
ホイール	ホイール
ライム	ライム
リーフ	リーフ
佐伯	サエキ
体中	カラダジュウ
冷	レイ
十字架	ジュウジカ
小川	オガワ
庁	チョウ
手先	テサキ
持ち歩く	モチアルク
済州	スミシュウ
うさぎ	ウサギ
タッチ	タッチ
トゲ	トゲ
ヒモ	ヒモ
マニア	マニア
ローレン	ローレン
一人前	イチニンマエ
再建	サイケン
大手	オオテ
昇格	ショウカク
清掃	セイソウ
素質	ソシツ
転職	テンショク
配信	ハイシン
そぐ	ソグ
まさしく	マサシク
促す	ウナガス
校内	コウナイ
確かめ	タシカメ
ワンピース	ワンピース
即	ソク
外側	ソトガワ
気まぐれ	キマグレ
結成	ケッセイ
野望	ヤボウ
こま	コマ
しつける	シツケル
フィッシャー	フィッシャー
吹き込む	フキコム
搬送	ハンソウ
洗濯物	センタクモノ
火曜日	カヨウビ
稲葉	イナバ
脂	アブラ
インタビュー	インタビュー
しゃく	シャク
休日	キュウジツ
励む	ハゲム
失態	シッタイ
止	シ
理想的	リソウテキ
ご免	ゴメン
入隊	ニュウタイ
夜勤	ヤキン
散らかる	チラカル
次回予告	ジカイヨコク
海老名	エビナ
菌	キン
覚ませる	サマセル
面談	メンダン
アール	アール
あばよ	アバヨ
おかず	オカズ
ボコボコ	ボコボコ
よろい	ヨロイ
低	テイ
裏側	ウラガワ
言いだす	イイダス
エール	エール
グレート	グレート
ダラス	ダラス
つむ	ツム
フロント	フロント
健闘	ケントウ
刻	コク
化す	カス
司法	シホウ
手短	テミジカ
瞑想	メイソウ
翔子	ショウコ
考え事	カンガエコト
退却	タイキャク
階級	カイキュウ
お出まし	オデマシ
コーリー	コーリー
やり取り	ヤリトリ
亭主	テイシュ
保てる	タモテル
好き勝手	スキカッテ
彫る	ホル
撃ち殺す	ウチコロス
習得	シュウトク
調	チョウ
じゃー	ジャー
わきまえる	ワキマエル
投降	トウコウ
指す	サス
望	ボウ
観念	カンネン
雪兎	ユキウサギ
いおう	イオウ
ギリシャ	ギリシャ
パイセン	パイセン
みなみ	ミナミ
作用	サヨウ
係長	カカリチョウ
健太郎	ケンタロウ
特性	トクセイ
産まれる	ウマレル
苦悩	クノウ
ダンク	ダンク
万里	バンリ
冷凍	レイトウ
居間	イマ
構想	コウソウ
民間人	ミンカンジン
無口	ムクチ
砦	トリデ
絹	キヌ
詩音	シオト
重罪	ジュウザイ
野村	ノムラ
カーペット	カーペット
ほんなら	ホンナラ
切開	セッカイ
大問題	ダイモンダイ
大気	タイキ
損害	ソンガイ
申し込む	モウシコム
ボット	ボット
内密に	ナイミツニ
後ほど	ノチホド
招集	ショウシュウ
明白	メイハク
空き	アキ
美沙	ミサ
説得力	セットクリョク
警視庁	ケイシチョウ
隊士	タイサムライ
ビンゴ	ビンゴ
ブレード	ブレード
公正	コウセイ
千春	チハル
哲学	テツガク
大隊	ダイタイ
液	エキ
細かく	コマカク
緊張感	キンチョウカン
視力	シリョク
イヌ	イヌ
ゲン	ゲン
こうした	コウシタ
コスプレ	コスプレ
コント	コント
ヒュー	ヒュー
上級	ジョウキュウ
傾く	カタムク
共和国	キョウワコク
左側	ヒダリガワ
生き残り	イキノコリ
衛門	エモン
おっきい	オッキイ
たらしい	タラシイ
ちの	チノ
レバー	レバー
二人とも	フタリトモ
人工	ジンコウ
切り	キリ
器用	キヨウ
水曜	スイヨウ
連携	レンケイ
願望	ガンボウ
エピソード	エピソード
サイコ	サイコ
すべる	スベル
つぶる	ツブル
ハンバーグ	ハンバーグ
ひす	ヒス
人の子	ニンノコ
充実	ジュウジツ
公安	コウアン
受験	ジュケン
志望	シボウ
愛子	アイコ
美術	ビジュツ
観戦	カンセン
速攻	ソッコウ
かみつく	カミツク
ネットワーク	ネットワーク
ビスケット	ビスケット
プロセス	プロセス
ポーカー	ポーカー
マドリード	マドリード
働かせる	ハタラカセル
コショウ	コショウ
サファイア	サファイア
メキシコ人	メキシコニン
ワームホール	ワームホール
創設者	ソウセツシャ
取り合う	トリアウ
孤立	コリツ
懐	フトコロ
成す	ナス
更生	コウセイ
長いこと	ナガイコト
アームストロング	アームストロング
ポーランド	ポーランド
惚れる	ホレル
月曜日	ゲツヨウビ
進学	シンガク
カシラ	カシラ
ふみ	フミ
フラメンコ	フラメンコ
ポニー	ポニー
届	トドケ
片手	カタテ
理恵	リエ
費	ヒ
送金	ソウキン
鎮静剤	チンセイザイ
ヴァルキリー	ヴァルキリー
シェルター	シェルター
シナトラ	シナトラ
ドリーム	ドリーム
れんげ	レンゲ
化ける	バケル
同様に	ドウヨウニ
唐辛子	トウガラシ
変異	ヘンイ
悪影響	アクエイキョウ
摘出	テキシュツ
言いなり	イイナリ
証	ショウ
須和	スワ
セリー	セリー
ティーン	ティーン
ペルー	ペルー
ボディー	ボディー
加	カ
勝敗	ショウハイ
射る	イル
手帳	テチョウ
納屋	ナヤ
跡部	アトベ
くわえる	クワエル
そむ	ソム
パトリシア	パトリシア
不調	フチョウ
投げ出す	ナゲダス
掲載	ケイサイ
文化祭	ブンカサイ
沿う	ソウ
疫病	エキビョウ
飲酒	インシュ
オビ	オビ
たどりつく	タドリツク
ちよみ	チヨミ
ですら	デスラ
リカルド	リカルド
特	トク
猶予	ユウヨ
管制官	カンセイカン
鑑定	カンテイ
雲母	ウンモ
アット	アット
カスタム	カスタム
しょせん	ショセン
ピクルス	ピクルス
モブ	モブ
もろ	モロ
モンロー	モンロー
主演	シュエン
塾	ジュク
心地	ココチ
迷路	メイロ
あおる	アオル
兎	ウサギ
妥当	ダトウ
措置	ソチ
社内	シャナイ
福富	フクトミ
裏庭	ウラニワ
ゴング	ゴング
ちかい	チカイ
できる限り	デキルカギリ
よりによって	ヨリニヨッテ
仮	カリ
危うく	アブナウク
検察官	ケンサツカン
研究員	ケンキュウイン
終身刑	シュウシンケイ
馬鹿	バカ
ニクソン	ニクソン
ひとみ	ヒトミ
反発	ハンパツ
柔道	ジュウドウ
梅	ウメ
消去	ショウキョ
袖	ソデ
補助	ホジョ
西谷	ニシタニ
面識	メンシキ
こねる	コネル
しんじる	シンジル
マヨネーズ	マヨネーズ
奉仕	ホウシ
政子	マサコ
祖先	ソセン
臭う	クサウ
あらあら	アラアラ
クッション	クッション
チェリー	チェリー
バニラ	バニラ
子供時代	コドモジダイ
星野	ホシノ
無人	ムジン
野心	ヤシン
黒田	クロダ
アメリカン	アメリカン
おっちゃん	オッチャン
カビ	カビ
ハント	ハント
ユイ	ユイ
伊	イ
少しも	スコシモ
火薬	カヤク
銅	ドウ
ナン	ナン
やんか	ヤンカ
太朗	タロウ
富井	トミイ
待ち合わせ	マチアワセ
支配者	シハイシャ
浅野	アサノ
股	マタ
衝動	ショウドウ
野獣	ヤジュウ
離	リ
アントニオ	アントニオ
カッコイイ	カッコイイ
ハーレム	ハーレム
マジカル	マジカル
三上	ミカミ
中島	ナカジマ
共犯	キョウハン
双方	ソウホウ
弱気	ヨワキ
込	コミ
ジーンズ	ジーンズ
デパート	デパート
ナイン	ナイン
上層部	ジョウソウブ
寺院	ジイン
導入	ドウニュウ
急速	キュウソク
支障	シショウ
最大限	サイダイゲン
満月	マンゲツ
独り占め	ヒトリジメ
辞退	ジタイ
お勧め	オススメ
セカンド	セカンド
トナカイ	トナカイ
フレンチ	フレンチ
上がり	アガリ
偽名	ギメイ
大野	オオノ
怯える	オビエル
縁起	エンギ
臨む	ノゾム
インド人	インドニン
おどる	オドル
クセ	クセ
ディスコ	ディスコ
侠	キョウ
創作	ソウサク
呼	コ
康	ヤスシ
新郎	シンロウ
朗報	ロウホウ
焼酎	ショウチュウ
薬草	ヤクソウ
金田	カネダ
テキーラ	テキーラ
フレーム	フレーム
リアクション	リアクション
人狼	ニンオオカミ
何故	ナゼ
千歳	チトセ
太平洋	タイヘイヨウ
男爵	ダンシャク
覚	カク
赤石	アカイシ
銭	セン
アルフレッド	アルフレッド
いやらしい	イヤラシイ
エアコン	エアコン
むす	ムス
リップ	リップ
人造人間	ジンゾウニンゲン
古泉	コイズミ
商	ショウ
工藤	クドウ
架	カ
脈拍	ミャクハク
走り回る	ハシリマワル
追及	ツイキュウ
確証	カクショウ
ショート	ショート
セラピスト	セラピスト
今ごろ	イマゴロ
凜	リン
圧	アツ
姉貴	アネキ
心理	シンリ
持ち場	モチバ
立	リツ
近いうちに	チカイウチニ
こぼれる	コボレル
ホワイトハウス	ホワイトハウス
上映	ジョウエイ
意	イ
早急	サッキュウ
言動	ゲンドウ
達者	タッシャ
エイズ	エイズ
しみ	シミ
スタント	スタント
ツル	ツル
まこと	マコト
亜空間	アクウカン
人員	ジンイン
呼ばわり	ヨバワリ
奪える	ウバエル
恐縮	キョウシュク
智恵	チエ
目前	モクゼン
１対１	１ツイ１
あれこれ	アレコレ
スウェーデン	スウェーデン
たら	タラ
ヘア	ヘア
レイバー	レイバー
切除	セツジョ
理性	リセイ
美希	ミキ
若葉	ワカバ
評議会	ヒョウギカイ
身代金	ミノシロキン
おかあさん	オカアサン
お医者さん	オイシャサン
ジェム	ジェム
ジャージ	ジャージ
セイ	セイ
だらし	ダラシ
モルヒネ	モルヒネ
乗り物	ノリモノ
代々	ダイダイ
切り離す	キリハナス
哲夫	テツオ
威厳	イゲン
心の底	ココロノソコ
治安	チアン
現れ	アラワレ
看護婦	カンゴフ
美蘭	ビラン
車輪	シャリン
エリス	エリス
クラウス	クラウス
バス停	バステイ
ひじ	ヒジ
ベタ	ベタ
ヨウ	ヨウ
ろくな	ロクナ
一度に	イチドニ
在住	ザイジュウ
天ぷら	テンプラ
悟史	サトシ
絶望的	ゼツボウテキ
邪魔者	ジャマモノ
プラスチック	プラスチック
ボニー	ボニー
再度	サイド
取り込み	トリコミ
呼び戻す	ヨビモドス
幼稚	ヨウチ
機材	キザイ
気づき	キヅキ
立て直す	タテナオス
苦い	ニガイ
貫通	カンツウ
オナニー	オナニー
ダイス	ダイス
プレート	プレート
便所	ベンジョ
僕達	ボクタチ
勧誘	カンユウ
夢子	ユメコ
嫁ぐ	トツグ
密告	ミッコク
復旧	フッキュウ
聴取	チョウシュ
辞職	ジショク
雑用	ザツヨウ
アク	アク
キッド	キッド
ロッジ	ロッジ
味わえる	アジワエル
墓場	ハカバ
実を言うと	ミヲイウト
柵	サク
消費	ショウヒ
車体	シャタイ
ご存知	ゴゾンジ
つるん	ツルン
テクニック	テクニック
ロマン	ロマン
三角	サンカク
仕立てる	シタテル
宣告	センコク
洋	ヒロシ
貫	カン
ツイッター	ツイッター
デジタル	デジタル
今になって	イマニナッテ
千鳥	チドリ
即興	ソッキョウ
在庫	ザイコ
強調	キョウチョウ
心拍	シンパク
時間の無駄	ジカンノムダ
綾小路	アヤノコウジ
退散	タイサン
ネル	ネル
ランキング	ランキング
一線	イッセン
作曲	サッキョク
分離	ブンリ
及び	オヨビ
同点	ドウテン
婦人	フジン
橋本	ハシモト
スティーヴン	スティーヴン
たわ言	タワゲン
成人	セイジン
滅亡	メツボウ
異変	イヘン
糖尿病	トウニョウビョウ
羽ばたく	ハネバタク
野放し	ノバナシ
オークション	オークション
さぞ	サゾ
たる	タル
つかう	ツカウ
ベルギー	ベルギー
凍結	トウケツ
守備	シュビ
屈する	クスル
